Office,Precinct,Early Ballots Cast,Election Ballots Cast,Total Ballots Cast,Registered Voters,Percent Turnout,REP Jim Wallace,DEM Herb Ritchie,Totals
"District Judge, 263rd Judicial District",0001,417,466,883,2358,37.45%,278,543,821
"District Judge, 263rd Judicial District",0002,333,313,646,1961,32.94%,259,344,603
"District Judge, 263rd Judicial District",0003,326,405,731,1560,46.86%,241,411,652
"District Judge, 263rd Judicial District",0004,369,487,856,1668,51.32%,284,498,782
"District Judge, 263rd Judicial District",0005,279,448,727,1417,51.31%,242,424,666
"District Judge, 263rd Judicial District",0006,656,456,1112,3702,30.04%,642,428,1070
"District Judge, 263rd Judicial District",0007,209,110,319,1017,31.37%,12,296,308
"District Judge, 263rd Judicial District",0008,393,310,703,1744,40.31%,348,320,668
"District Judge, 263rd Judicial District",0009,206,223,429,1874,22.89%,115,284,399
"District Judge, 263rd Judicial District",0010,255,171,426,1753,24.30%,131,267,398
"District Judge, 263rd Judicial District",0011,184,176,360,1785,20.17%,74,261,335
"District Judge, 263rd Judicial District",0012,86,66,152,735,20.68%,87,61,148
"District Judge, 263rd Judicial District",0013,548,361,909,2689,33.80%,660,210,870
"District Judge, 263rd Judicial District",0014,442,495,937,1870,50.11%,474,404,878
"District Judge, 263rd Judicial District",0015,597,898,1495,2878,51.95%,809,568,1377
"District Judge, 263rd Judicial District",0016,239,137,376,1071,35.11%,171,184,355
"District Judge, 263rd Judicial District",0017,185,215,400,1162,34.42%,168,204,372
"District Judge, 263rd Judicial District",0018,371,351,722,1443,50.03%,313,355,668
"District Judge, 263rd Judicial District",0019,170,207,377,1170,32.22%,120,238,358
"District Judge, 263rd Judicial District",0020,311,287,598,2646,22.60%,168,402,570
"District Judge, 263rd Judicial District",0021,176,184,360,1122,32.09%,70,271,341
"District Judge, 263rd Judicial District",0022,397,322,719,2473,29.07%,130,565,695
"District Judge, 263rd Judicial District",0023,31,22,53,541,9.80%,10,42,52
"District Judge, 263rd Judicial District",0024,106,88,194,655,29.62%,16,171,187
"District Judge, 263rd Judicial District",0025,104,143,247,1086,22.74%,12,230,242
"District Judge, 263rd Judicial District",0026,239,277,516,1845,27.97%,136,331,467
"District Judge, 263rd Judicial District",0027,463,427,890,3074,28.95%,221,614,835
"District Judge, 263rd Judicial District",0028,636,405,1041,3029,34.37%,667,323,990
"District Judge, 263rd Judicial District",0029,194,237,431,2638,16.34%,174,234,408
"District Judge, 263rd Judicial District",0030,368,391,759,2403,31.59%,194,533,727
"District Judge, 263rd Judicial District",0031,453,280,733,2511,29.19%,18,693,711
"District Judge, 263rd Judicial District",0032,318,405,723,2398,30.15%,280,395,675
"District Judge, 263rd Judicial District",0033,707,615,1322,3706,35.67%,406,829,1235
"District Judge, 263rd Judicial District",0034,625,579,1204,2786,43.22%,266,875,1141
"District Judge, 263rd Judicial District",0035,4,0,4,11,36.36%,1,3,4
"District Judge, 263rd Judicial District",0036,416,318,734,2927,25.08%,199,491,690
"District Judge, 263rd Judicial District",0037,542,436,978,2106,46.44%,270,643,913
"District Judge, 263rd Judicial District",0038,784,589,1373,2875,47.76%,436,843,1279
"District Judge, 263rd Judicial District",0039,657,575,1232,2759,44.65%,289,864,1153
"District Judge, 263rd Judicial District",0040,136,152,288,541,53.23%,123,147,270
"District Judge, 263rd Judicial District",0041,176,230,406,1334,30.43%,165,229,394
"District Judge, 263rd Judicial District",0042,228,109,337,1071,31.47%,6,321,327
"District Judge, 263rd Judicial District",0043,293,210,503,1695,29.68%,272,206,478
"District Judge, 263rd Judicial District",0044,204,222,426,2001,21.29%,102,293,395
"District Judge, 263rd Judicial District",0045,894,750,1644,6698,24.54%,335,1260,1595
"District Judge, 263rd Judicial District",0046,290,247,537,2511,21.39%,97,412,509
"District Judge, 263rd Judicial District",0047,213,218,431,1627,26.49%,16,406,422
"District Judge, 263rd Judicial District",0048,157,142,299,940,31.81%,25,267,292
"District Judge, 263rd Judicial District",0049,584,482,1066,3343,31.89%,782,251,1033
"District Judge, 263rd Judicial District",0050,785,771,1556,5211,29.86%,857,646,1503
"District Judge, 263rd Judicial District",0051,353,243,596,1689,35.29%,451,125,576
"District Judge, 263rd Judicial District",0052,422,447,869,2457,35.37%,396,418,814
"District Judge, 263rd Judicial District",0053,564,726,1290,2971,43.42%,490,715,1205
"District Judge, 263rd Judicial District",0054,269,364,633,1487,42.57%,321,272,593
"District Judge, 263rd Judicial District",0055,191,251,442,1506,29.35%,196,214,410
"District Judge, 263rd Judicial District",0056,282,278,560,1326,42.23%,370,164,534
"District Judge, 263rd Judicial District",0057,710,831,1541,3153,48.87%,566,845,1411
"District Judge, 263rd Judicial District",0058,469,556,1025,2690,38.10%,426,550,976
"District Judge, 263rd Judicial District",0059,555,609,1164,2544,45.75%,440,650,1090
"District Judge, 263rd Judicial District",0060,498,564,1062,2453,43.29%,254,732,986
"District Judge, 263rd Judicial District",0061,172,204,376,1773,21.21%,157,193,350
"District Judge, 263rd Judicial District",0062,145,322,467,2181,21.41%,126,318,444
"District Judge, 263rd Judicial District",0063,264,354,618,1826,33.84%,498,100,598
"District Judge, 263rd Judicial District",0064,191,221,412,2141,19.24%,90,297,387
"District Judge, 263rd Judicial District",0065,172,230,402,2167,18.55%,103,277,380
"District Judge, 263rd Judicial District",0066,69,143,212,1098,19.31%,37,162,199
"District Judge, 263rd Judicial District",0067,304,282,586,2794,20.97%,168,376,544
"District Judge, 263rd Judicial District",0068,553,352,905,2924,30.95%,22,861,883
"District Judge, 263rd Judicial District",0069,80,124,204,1284,15.89%,43,145,188
"District Judge, 263rd Judicial District",0070,882,664,1546,3337,46.33%,858,550,1408
"District Judge, 263rd Judicial District",0071,602,722,1324,4197,31.55%,641,610,1251
"District Judge, 263rd Judicial District",0072,220,293,513,1924,26.66%,170,315,485
"District Judge, 263rd Judicial District",0073,252,414,666,1555,42.83%,365,244,609
"District Judge, 263rd Judicial District",0074,1153,782,1935,3583,54.01%,1507,351,1858
"District Judge, 263rd Judicial District",0075,254,280,534,1444,36.98%,197,305,502
"District Judge, 263rd Judicial District",0076,373,374,747,2362,31.63%,437,273,710
"District Judge, 263rd Judicial District",0077,43,46,89,566,15.72%,20,65,85
"District Judge, 263rd Judicial District",0078,180,201,381,1522,25.03%,142,221,363
"District Judge, 263rd Judicial District",0079,205,306,511,2927,17.46%,129,334,463
"District Judge, 263rd Judicial District",0080,501,351,852,2725,31.27%,222,592,814
"District Judge, 263rd Judicial District",0081,183,187,370,1835,20.16%,151,197,348
"District Judge, 263rd Judicial District",0082,639,671,1310,3368,38.90%,984,289,1273
"District Judge, 263rd Judicial District",0083,1296,888,2184,6625,32.97%,1074,1034,2108
"District Judge, 263rd Judicial District",0084,208,218,426,1373,31.03%,309,101,410
"District Judge, 263rd Judicial District",0085,271,248,519,2173,23.88%,24,485,509
"District Judge, 263rd Judicial District",0086,447,568,1015,2910,34.88%,444,509,953
"District Judge, 263rd Judicial District",0087,574,787,1461,2818,51.85%,867,483,1350
"District Judge, 263rd Judicial District",0088,123,118,241,693,34.78%,153,74,227
"District Judge, 263rd Judicial District",0089,165,371,536,1094,48.99%,266,217,483
"District Judge, 263rd Judicial District",0090,844,790,1634,3700,44.16%,1174,396,1570
"District Judge, 263rd Judicial District",0091,219,222,441,1505,29.30%,265,159,424
"District Judge, 263rd Judicial District",0092,695,462,1157,2242,51.61%,747,333,1080
"District Judge, 263rd Judicial District",0093,381,301,682,3356,20.32%,280,363,643
"District Judge, 263rd Judicial District",0094,51,43,94,549,17.12%,28,63,91
"District Judge, 263rd Judicial District",0095,917,576,1493,3177,46.99%,1066,358,1424
"District Judge, 263rd Judicial District",0096,83,83,166,1296,12.81%,21,144,165
"District Judge, 263rd Judicial District",0097,1024,725,1749,4828,36.23%,1303,385,1688
"District Judge, 263rd Judicial District",0098,403,488,891,2651,33.61%,740,121,861
"District Judge, 263rd Judicial District",0099,254,184,438,2092,20.94%,213,211,424
"District Judge, 263rd Judicial District",0100,155,173,338,1730,19.54%,184,147,331
"District Judge, 263rd Judicial District",0101,72,58,130,946,13.74%,48,79,127
"District Judge, 263rd Judicial District",0102,207,121,328,1872,17.52%,95,223,318
"District Judge, 263rd Judicial District",0103,700,714,1414,5371,26.33%,812,560,1372
"District Judge, 263rd Judicial District",0104,530,231,761,1905,39.95%,22,724,746
"District Judge, 263rd Judicial District",0105,195,210,406,2165,18.75%,142,232,374
"District Judge, 263rd Judicial District",0106,15,7,25,294,8.50%,16,9,25
"District Judge, 263rd Judicial District",0107,154,197,351,2032,17.27%,59,276,335
"District Judge, 263rd Judicial District",0108,558,272,940,3365,27.93%,574,331,905
"District Judge, 263rd Judicial District",0109,529,245,774,2824,27.41%,9,748,757
"District Judge, 263rd Judicial District",0110,554,494,1148,3042,37.74%,745,363,1108
"District Judge, 263rd Judicial District",0111,815,795,1611,4102,39.27%,1182,361,1543
"District Judge, 263rd Judicial District",0112,542,485,1027,2976,34.51%,754,233,987
"District Judge, 263rd Judicial District",0113,552,429,991,2647,37.44%,605,338,943
"District Judge, 263rd Judicial District",0114,707,547,1254,3311,37.87%,1016,207,1223
"District Judge, 263rd Judicial District",0115,238,150,388,1800,21.56%,50,326,376
"District Judge, 263rd Judicial District",0116,982,776,1758,3147,55.86%,1313,337,1650
"District Judge, 263rd Judicial District",0117,215,226,441,1880,23.46%,221,199,420
"District Judge, 263rd Judicial District",0118,304,123,427,759,56.26%,347,68,415
"District Judge, 263rd Judicial District",0119,1288,1024,2312,5500,42.04%,1873,353,2226
"District Judge, 263rd Judicial District",0120,712,422,1134,3191,35.54%,731,351,1082
"District Judge, 263rd Judicial District",0121,92,178,270,848,31.84%,191,67,258
"District Judge, 263rd Judicial District",0122,352,225,577,1890,30.53%,26,538,564
"District Judge, 263rd Judicial District",0123,284,288,572,1392,41.09%,140,397,537
"District Judge, 263rd Judicial District",0124,1734,1292,3026,7254,41.71%,2393,552,2945
"District Judge, 263rd Judicial District",0125,415,332,747,2405,31.06%,466,253,719
"District Judge, 263rd Judicial District",0126,893,467,1360,3100,43.87%,1203,120,1323
"District Judge, 263rd Judicial District",0127,435,154,589,1836,32.08%,415,141,556
"District Judge, 263rd Judicial District",0128,445,707,1152,2290,50.31%,672,382,1054
"District Judge, 263rd Judicial District",0129,1030,1200,2230,5746,38.81%,1362,748,2110
"District Judge, 263rd Judicial District",0130,727,523,1250,2333,53.58%,906,279,1185
"District Judge, 263rd Judicial District",0131,251,259,510,1935,26.36%,125,360,485
"District Judge, 263rd Judicial District",0132,593,323,916,2387,38.37%,19,878,897
"District Judge, 263rd Judicial District",0133,513,858,1371,2662,51.50%,758,497,1255
"District Judge, 263rd Judicial District",0134,192,265,457,1437,31.80%,211,224,435
"District Judge, 263rd Judicial District",0135,727,579,1305,2671,48.90%,854,379,1233
"District Judge, 263rd Judicial District",0136,503,371,874,2013,43.42%,29,816,845
"District Judge, 263rd Judicial District",0137,166,141,307,716,42.88%,143,136,279
"District Judge, 263rd Judicial District",0138,296,199,495,1699,29.13%,17,470,487
"District Judge, 263rd Judicial District",0139,699,551,1250,3037,41.16%,518,651,1169
"District Judge, 263rd Judicial District",0140,699,480,1179,3214,36.68%,131,1001,1132
"District Judge, 263rd Judicial District",0141,80,80,160,855,18.71%,96,55,151
"District Judge, 263rd Judicial District",0142,87,103,190,902,21.06%,62,118,180
"District Judge, 263rd Judicial District",0143,1962,580,2542,6386,39.81%,1839,644,2483
"District Judge, 263rd Judicial District",0144,216,158,374,1093,34.22%,11,354,365
"District Judge, 263rd Judicial District",0145,264,213,477,1538,31.01%,9,456,465
"District Judge, 263rd Judicial District",0146,426,519,945,2008,47.06%,399,493,892
"District Judge, 263rd Judicial District",0147,589,329,1018,3008,33.84%,130,861,991
"District Judge, 263rd Judicial District",0148,500,780,1280,2540,50.39%,454,719,1173
"District Judge, 263rd Judicial District",0149,1621,737,2358,7993,29.50%,1224,1069,2293
"District Judge, 263rd Judicial District",0150,236,169,405,1256,32.25%,12,388,400
"District Judge, 263rd Judicial District",0151,137,79,216,826,26.15%,10,198,208
"District Judge, 263rd Judicial District",0152,213,299,512,2788,18.36%,143,346,489
"District Judge, 263rd Judicial District",0153,125,206,331,1808,18.31%,112,203,315
"District Judge, 263rd Judicial District",0154,249,183,432,2190,19.73%,116,293,409
"District Judge, 263rd Judicial District",0155,1022,619,1641,4109,39.94%,1132,451,1583
"District Judge, 263rd Judicial District",0156,799,326,1125,3071,36.63%,40,1053,1093
"District Judge, 263rd Judicial District",0157,448,214,662,2236,29.61%,24,621,645
"District Judge, 263rd Judicial District",0158,600,315,915,3035,30.15%,27,871,898
"District Judge, 263rd Judicial District",0159,116,127,243,998,24.35%,38,198,236
"District Judge, 263rd Judicial District",0160,122,73,195,696,28.02%,6,187,193
"District Judge, 263rd Judicial District",0161,163,141,304,991,30.68%,4,292,296
"District Judge, 263rd Judicial District",0162,101,83,184,1265,14.55%,70,102,172
"District Judge, 263rd Judicial District",0163,230,320,550,3037,18.11%,241,281,522
"District Judge, 263rd Judicial District",0164,182,205,387,1420,27.25%,11,367,378
"District Judge, 263rd Judicial District",0165,535,483,1018,2334,43.62%,665,301,966
"District Judge, 263rd Judicial District",0166,158,233,391,1028,38.04%,111,256,367
"District Judge, 263rd Judicial District",0167,3,0,3,24,12.50%,0,3,3
"District Judge, 263rd Judicial District",0168,92,58,150,503,29.82%,2,145,147
"District Judge, 263rd Judicial District",0169,518,251,767,2513,30.52%,13,733,746
"District Judge, 263rd Judicial District",0170,271,141,412,1869,22.04%,220,172,392
"District Judge, 263rd Judicial District",0171,202,198,400,1604,24.94%,13,380,393
"District Judge, 263rd Judicial District",0172,88,80,166,621,26.73%,64,90,154
"District Judge, 263rd Judicial District",0173,817,739,1556,3599,43.23%,1251,252,1503
"District Judge, 263rd Judicial District",0174,829,733,1562,3296,47.39%,1046,422,1468
"District Judge, 263rd Judicial District",0175,557,749,1306,2618,49.89%,632,568,1200
"District Judge, 263rd Judicial District",0176,344,451,795,1602,49.63%,395,326,721
"District Judge, 263rd Judicial District",0177,278,326,604,1496,40.37%,323,237,560
"District Judge, 263rd Judicial District",0178,504,365,869,1765,49.24%,566,239,805
"District Judge, 263rd Judicial District",0179,256,188,444,1575,28.19%,240,180,420
"District Judge, 263rd Judicial District",0180,470,343,813,2834,28.69%,25,748,773
"District Judge, 263rd Judicial District",0181,175,262,437,2061,21.20%,143,272,415
"District Judge, 263rd Judicial District",0182,590,974,1564,3405,45.93%,905,521,1426
"District Judge, 263rd Judicial District",0183,519,794,1313,2491,52.71%,801,411,1212
"District Judge, 263rd Judicial District",0184,106,135,241,994,24.25%,88,134,222
"District Judge, 263rd Judicial District",0185,283,292,575,1933,29.75%,207,340,547
"District Judge, 263rd Judicial District",0186,97,106,203,798,25.44%,35,161,196
"District Judge, 263rd Judicial District",0187,21,25,46,311,14.79%,15,29,44
"District Judge, 263rd Judicial District",0188,153,146,299,1637,18.27%,144,143,287
"District Judge, 263rd Judicial District",0189,239,360,599,1465,40.89%,312,246,558
"District Judge, 263rd Judicial District",0190,120,177,297,1723,17.24%,129,156,285
"District Judge, 263rd Judicial District",0191,79,126,205,1366,15.01%,89,108,197
"District Judge, 263rd Judicial District",0192,380,225,605,1959,30.88%,25,563,588
"District Judge, 263rd Judicial District",0193,173,187,360,1074,33.52%,7,339,346
"District Judge, 263rd Judicial District",0194,350,431,781,1912,40.85%,229,511,740
"District Judge, 263rd Judicial District",0195,269,278,547,1694,32.29%,19,515,534
"District Judge, 263rd Judicial District",0196,52,32,84,316,26.58%,6,76,82
"District Judge, 263rd Judicial District",0197,543,309,852,2914,29.24%,18,816,834
"District Judge, 263rd Judicial District",0198,53,74,127,642,19.78%,2,124,126
"District Judge, 263rd Judicial District",0199,812,661,1473,3216,45.80%,1142,267,1409
"District Judge, 263rd Judicial District",0200,962,536,1498,3382,44.29%,641,747,1388
"District Judge, 263rd Judicial District",0201,98,87,185,724,25.55%,2,178,180
"District Judge, 263rd Judicial District",0202,217,189,406,1464,27.73%,15,384,399
"District Judge, 263rd Judicial District",0203,107,68,175,960,18.23%,43,124,167
"District Judge, 263rd Judicial District",0204,816,784,1600,3487,45.88%,872,603,1475
"District Judge, 263rd Judicial District",0205,464,171,635,1664,38.16%,11,613,624
"District Judge, 263rd Judicial District",0206,362,462,824,2779,29.65%,236,537,773
"District Judge, 263rd Judicial District",0207,265,261,526,1188,44.28%,169,329,498
"District Judge, 263rd Judicial District",0208,322,262,584,2195,26.61%,183,373,556
"District Judge, 263rd Judicial District",0209,0,2,2,0,0.00%,2,0,2
"District Judge, 263rd Judicial District",0210,502,467,969,2533,38.26%,105,836,941
"District Judge, 263rd Judicial District",0211,307,386,693,2914,23.78%,267,385,652
"District Judge, 263rd Judicial District",0212,96,155,251,1300,19.31%,58,185,243
"District Judge, 263rd Judicial District",0213,826,913,1739,3350,51.91%,1330,295,1625
"District Judge, 263rd Judicial District",0214,404,491,895,1854,48.27%,542,294,836
"District Judge, 263rd Judicial District",0215,421,711,1132,2258,50.13%,648,402,1050
"District Judge, 263rd Judicial District",0216,362,223,585,1945,30.08%,40,532,572
"District Judge, 263rd Judicial District",0217,844,631,1475,2678,55.08%,890,463,1353
"District Judge, 263rd Judicial District",0218,391,402,793,2292,34.60%,243,484,727
"District Judge, 263rd Judicial District",0219,496,436,932,2767,33.68%,47,844,891
"District Judge, 263rd Judicial District",0220,325,187,512,2310,22.16%,372,125,497
"District Judge, 263rd Judicial District",0221,332,369,701,2529,27.72%,316,348,664
"District Judge, 263rd Judicial District",0222,623,674,1297,2501,51.86%,546,647,1193
"District Judge, 263rd Judicial District",0223,563,377,940,3582,26.24%,249,632,881
"District Judge, 263rd Judicial District",0224,530,456,986,2238,44.06%,433,482,915
"District Judge, 263rd Judicial District",0225,376,405,781,3305,23.63%,396,355,751
"District Judge, 263rd Judicial District",0226,227,307,534,2436,21.92%,136,369,505
"District Judge, 263rd Judicial District",0227,558,423,981,1785,54.96%,671,223,894
"District Judge, 263rd Judicial District",0228,362,195,557,1050,53.05%,29,503,532
"District Judge, 263rd Judicial District",0229,31,96,127,815,15.58%,61,59,120
"District Judge, 263rd Judicial District",0230,185,116,301,1089,27.64%,6,287,293
"District Judge, 263rd Judicial District",0231,233,264,497,2232,22.27%,129,338,467
"District Judge, 263rd Judicial District",0232,361,474,835,1760,47.44%,427,348,775
"District Judge, 263rd Judicial District",0233,890,801,1691,4445,38.04%,771,787,1558
"District Judge, 263rd Judicial District",0234,1192,913,2105,3993,52.72%,1522,440,1962
"District Judge, 263rd Judicial District",0235,240,158,398,1356,29.35%,13,372,385
"District Judge, 263rd Judicial District",0236,354,235,589,2079,28.33%,14,561,575
"District Judge, 263rd Judicial District",0237,416,253,669,2161,30.96%,13,642,655
"District Judge, 263rd Judicial District",0238,339,245,584,1925,30.34%,15,553,568
"District Judge, 263rd Judicial District",0239,383,236,619,1964,31.52%,22,588,610
"District Judge, 263rd Judicial District",0240,585,243,828,2649,31.26%,18,792,810
"District Judge, 263rd Judicial District",0241,222,229,451,2372,19.01%,193,240,433
"District Judge, 263rd Judicial District",0242,173,162,335,1596,20.99%,200,119,319
"District Judge, 263rd Judicial District",0243,138,43,181,457,39.61%,1,179,180
"District Judge, 263rd Judicial District",0244,480,425,905,3117,29.03%,504,356,860
"District Judge, 263rd Judicial District",0245,945,799,1745,5828,29.94%,1227,477,1704
"District Judge, 263rd Judicial District",0246,584,513,1197,3315,36.11%,856,301,1157
"District Judge, 263rd Judicial District",0247,173,254,427,1582,26.99%,13,408,421
"District Judge, 263rd Judicial District",0248,161,167,328,2100,15.62%,93,221,314
"District Judge, 263rd Judicial District",0249,461,348,809,2719,29.75%,571,211,782
"District Judge, 263rd Judicial District",0250,109,164,273,964,28.32%,11,257,268
"District Judge, 263rd Judicial District",0251,278,436,714,2089,34.18%,26,674,700
"District Judge, 263rd Judicial District",0252,504,312,816,2377,34.33%,14,784,798
"District Judge, 263rd Judicial District",0253,379,222,601,2177,27.61%,12,577,589
"District Judge, 263rd Judicial District",0254,93,112,205,1550,13.23%,70,127,197
"District Judge, 263rd Judicial District",0255,525,648,1173,2482,47.26%,520,572,1092
"District Judge, 263rd Judicial District",0256,575,449,1024,3254,31.47%,491,483,974
"District Judge, 263rd Judicial District",0257,204,245,449,2523,17.80%,134,289,423
"District Judge, 263rd Judicial District",0258,839,800,1539,3322,49.34%,1163,365,1528
"District Judge, 263rd Judicial District",0259,555,382,1038,2361,43.96%,28,983,1011
"District Judge, 263rd Judicial District",0260,162,145,307,1260,24.37%,183,103,286
"District Judge, 263rd Judicial District",0261,124,120,244,1417,17.22%,104,131,235
"District Judge, 263rd Judicial District",0262,758,600,1358,4397,30.88%,840,437,1277
"District Judge, 263rd Judicial District",0263,858,712,1570,3693,42.51%,1205,307,1512
"District Judge, 263rd Judicial District",0264,480,457,937,2963,31.62%,580,301,881
"District Judge, 263rd Judicial District",0265,988,759,1747,3584,48.74%,1268,365,1633
"District Judge, 263rd Judicial District",0266,259,257,516,2104,24.52%,259,229,488
"District Judge, 263rd Judicial District",0267,146,166,312,1327,23.51%,166,128,294
"District Judge, 263rd Judicial District",0268,435,717,1152,2493,46.21%,632,397,1029
"District Judge, 263rd Judicial District",0269,702,453,1155,2030,56.90%,862,218,1080
"District Judge, 263rd Judicial District",0270,817,672,1489,3605,41.30%,824,582,1406
"District Judge, 263rd Judicial District",0271,656,382,1038,2518,41.22%,29,998,1027
"District Judge, 263rd Judicial District",0272,264,292,555,2162,25.72%,217,312,529
"District Judge, 263rd Judicial District",0273,548,689,1237,2470,50.08%,976,198,1174
"District Judge, 263rd Judicial District",0274,588,346,934,2153,43.38%,623,247,870
"District Judge, 263rd Judicial District",0275,207,236,443,1850,23.95%,106,323,429
"District Judge, 263rd Judicial District",0276,572,231,803,2536,31.66%,10,781,791
"District Judge, 263rd Judicial District",0277,170,186,356,1492,23.86%,168,173,341
"District Judge, 263rd Judicial District",0278,421,320,741,2454,30.20%,417,293,710
"District Judge, 263rd Judicial District",0279,250,223,473,1941,24.37%,280,171,451
"District Judge, 263rd Judicial District",0280,130,188,318,1524,20.87%,135,166,301
"District Judge, 263rd Judicial District",0281,655,742,1397,2633,53.06%,609,647,1256
"District Judge, 263rd Judicial District",0282,314,455,769,2042,37.66%,478,248,726
"District Judge, 263rd Judicial District",0283,0,0,0,0,0.00%,0,0,0
"District Judge, 263rd Judicial District",0284,574,336,910,3172,28.69%,422,446,868
"District Judge, 263rd Judicial District",0285,448,378,826,2540,32.52%,77,724,801
"District Judge, 263rd Judicial District",0286,1255,821,2076,6170,33.65%,195,1815,2010
"District Judge, 263rd Judicial District",0287,370,477,847,1621,52.25%,401,390,791
"District Judge, 263rd Judicial District",0288,532,313,845,2210,38.24%,17,814,831
"District Judge, 263rd Judicial District",0289,186,212,398,1564,25.45%,205,170,375
"District Judge, 263rd Judicial District",0290,245,298,543,1642,33.07%,408,115,523
"District Judge, 263rd Judicial District",0291,325,235,560,1225,45.71%,278,250,528
"District Judge, 263rd Judicial District",0292,207,147,354,1356,26.11%,44,301,345
"District Judge, 263rd Judicial District",0293,356,447,803,1759,45.65%,356,388,744
"District Judge, 263rd Judicial District",0294,488,221,709,2097,33.81%,12,680,692
"District Judge, 263rd Judicial District",0295,148,103,251,885,28.36%,7,239,246
"District Judge, 263rd Judicial District",0296,327,340,667,1713,38.94%,379,244,623
"District Judge, 263rd Judicial District",0297,280,249,529,2012,26.29%,233,262,495
"District Judge, 263rd Judicial District",0298,415,358,773,2121,36.45%,456,268,724
"District Judge, 263rd Judicial District",0299,178,117,295,1353,21.80%,115,158,273
"District Judge, 263rd Judicial District",0300,1389,1016,2405,5406,44.49%,1905,402,2307
"District Judge, 263rd Judicial District",0301,210,255,465,2352,19.77%,195,245,440
"District Judge, 263rd Judicial District",0302,353,343,696,2720,25.59%,410,262,672
"District Judge, 263rd Judicial District",0303,922,784,1706,3245,52.57%,1329,292,1621
"District Judge, 263rd Judicial District",0304,606,505,1111,2298,48.35%,583,444,1027
"District Judge, 263rd Judicial District",0305,524,432,956,4191,22.81%,408,518,926
"District Judge, 263rd Judicial District",0306,649,342,991,1879,52.74%,689,239,928
"District Judge, 263rd Judicial District",0307,733,670,1403,3099,45.27%,933,384,1317
"District Judge, 263rd Judicial District",0308,199,130,329,1296,25.39%,115,199,314
"District Judge, 263rd Judicial District",0309,708,593,1301,2524,51.55%,1011,208,1219
"District Judge, 263rd Judicial District",0310,386,279,665,1435,46.34%,443,176,619
"District Judge, 263rd Judicial District",0311,486,421,907,2986,30.38%,489,355,844
"District Judge, 263rd Judicial District",0312,742,457,1199,3636,32.98%,757,387,1144
"District Judge, 263rd Judicial District",0313,9,0,9,62,14.52%,7,2,9
"District Judge, 263rd Judicial District",0314,1121,913,2034,5647,36.02%,1280,689,1969
"District Judge, 263rd Judicial District",0315,478,388,866,1608,53.86%,497,311,808
"District Judge, 263rd Judicial District",0316,412,341,753,1537,48.99%,379,317,696
"District Judge, 263rd Judicial District",0317,248,209,457,1588,28.78%,150,286,436
"District Judge, 263rd Judicial District",0318,834,568,1402,3660,38.31%,69,1289,1358
"District Judge, 263rd Judicial District",0319,512,230,742,2158,34.38%,45,674,719
"District Judge, 263rd Judicial District",0320,234,168,402,1537,26.15%,209,178,387
"District Judge, 263rd Judicial District",0321,262,191,453,2346,19.31%,168,256,424
"District Judge, 263rd Judicial District",0322,181,129,310,1226,25.29%,101,197,298
"District Judge, 263rd Judicial District",0323,278,211,489,1722,28.40%,231,227,458
"District Judge, 263rd Judicial District",0324,532,646,1178,2336,50.43%,716,374,1090
"District Judge, 263rd Judicial District",0325,289,193,482,2112,22.82%,106,358,464
"District Judge, 263rd Judicial District",0326,87,74,161,698,23.07%,78,75,153
"District Judge, 263rd Judicial District",0327,380,129,509,1729,29.44%,10,484,494
"District Judge, 263rd Judicial District",0328,151,140,291,1434,20.29%,131,145,276
"District Judge, 263rd Judicial District",0329,189,184,373,1397,26.70%,146,207,353
"District Judge, 263rd Judicial District",0330,334,253,587,1936,30.32%,327,228,555
"District Judge, 263rd Judicial District",0331,0,0,0,0,0.00%,0,0,0
"District Judge, 263rd Judicial District",0332,18,7,25,138,18.12%,11,10,21
"District Judge, 263rd Judicial District",0333,524,714,1238,3021,40.98%,864,312,1176
"District Judge, 263rd Judicial District",0334,83,42,125,742,16.85%,21,100,121
"District Judge, 263rd Judicial District",0335,121,98,219,1300,16.85%,86,117,203
"District Judge, 263rd Judicial District",0336,866,624,1490,4051,36.78%,138,1317,1455
"District Judge, 263rd Judicial District",0337,124,103,227,1029,22.06%,41,177,218
"District Judge, 263rd Judicial District",0338,730,391,1121,4934,22.72%,382,658,1040
"District Judge, 263rd Judicial District",0339,202,222,424,1757,24.13%,91,306,397
"District Judge, 263rd Judicial District",0340,1038,594,1632,3765,43.35%,1229,335,1564
"District Judge, 263rd Judicial District",0341,91,167,258,1290,20.00%,82,168,250
"District Judge, 263rd Judicial District",0342,675,605,1280,6526,19.61%,215,1033,1248
"District Judge, 263rd Judicial District",0343,189,271,460,1964,23.42%,141,293,434
"District Judge, 263rd Judicial District",0344,154,172,326,1160,28.10%,14,298,312
"District Judge, 263rd Judicial District",0345,156,165,321,1804,17.79%,94,210,304
"District Judge, 263rd Judicial District",0346,0,1,1,3,33.33%,1,0,1
"District Judge, 263rd Judicial District",0347,592,436,1028,3387,30.35%,693,300,993
"District Judge, 263rd Judicial District",0348,438,208,646,1708,37.82%,502,118,620
"District Judge, 263rd Judicial District",0349,188,267,455,1349,33.73%,281,151,432
"District Judge, 263rd Judicial District",0350,524,526,1050,2909,36.09%,401,564,965
"District Judge, 263rd Judicial District",0351,1491,710,2201,4712,46.71%,1729,387,2116
"District Judge, 263rd Judicial District",0352,520,339,859,3205,26.80%,632,192,824
"District Judge, 263rd Judicial District",0353,665,451,1116,3862,28.90%,213,866,1079
"District Judge, 263rd Judicial District",0354,715,338,1053,3388,31.08%,271,748,1019
"District Judge, 263rd Judicial District",0355,301,264,565,1560,36.22%,49,499,548
"District Judge, 263rd Judicial District",0356,594,538,1132,2972,38.09%,725,350,1075
"District Judge, 263rd Judicial District",0357,837,575,1412,3517,40.15%,1029,331,1360
"District Judge, 263rd Judicial District",0358,212,254,466,2492,18.70%,56,396,452
"District Judge, 263rd Judicial District",0359,234,224,458,3061,14.96%,58,387,445
"District Judge, 263rd Judicial District",0360,522,380,902,2146,42.03%,450,372,822
"District Judge, 263rd Judicial District",0361,41,295,336,1673,20.08%,51,245,296
"District Judge, 263rd Judicial District",0362,1138,887,2025,5086,39.82%,1498,423,1921
"District Judge, 263rd Judicial District",0363,620,412,1032,3677,28.07%,472,533,1005
"District Judge, 263rd Judicial District",0364,488,405,893,2658,33.60%,519,332,851
"District Judge, 263rd Judicial District",0365,478,231,709,1305,54.33%,48,643,691
"District Judge, 263rd Judicial District",0366,252,270,522,2454,21.27%,144,365,509
"District Judge, 263rd Judicial District",0367,170,138,308,1130,27.26%,68,233,301
"District Judge, 263rd Judicial District",0368,178,88,266,958,27.77%,73,182,255
"District Judge, 263rd Judicial District",0369,32,29,61,559,10.91%,18,41,59
"District Judge, 263rd Judicial District",0370,1532,1105,2637,6593,40.00%,2002,543,2545
"District Judge, 263rd Judicial District",0371,122,52,174,502,34.66%,6,161,167
"District Judge, 263rd Judicial District",0372,221,170,391,1224,31.94%,53,323,376
"District Judge, 263rd Judicial District",0373,21,12,33,157,21.02%,2,29,31
"District Judge, 263rd Judicial District",0374,65,93,158,738,21.41%,59,95,154
"District Judge, 263rd Judicial District",0375,254,220,474,2645,17.92%,242,196,438
"District Judge, 263rd Judicial District",0376,278,205,483,1910,25.29%,221,238,459
"District Judge, 263rd Judicial District",0377,525,583,1109,2920,37.98%,809,245,1054
"District Judge, 263rd Judicial District",0378,232,354,586,1829,32.04%,369,193,562
"District Judge, 263rd Judicial District",0379,431,289,720,2027,35.52%,72,627,699
"District Judge, 263rd Judicial District",0380,1299,995,2294,5666,40.49%,1258,961,2219
"District Judge, 263rd Judicial District",0381,412,248,660,2855,23.12%,314,322,636
"District Judge, 263rd Judicial District",0382,132,157,289,922,31.34%,218,63,281
"District Judge, 263rd Judicial District",0383,289,263,552,2173,25.40%,232,300,532
"District Judge, 263rd Judicial District",0384,573,373,946,2657,35.60%,186,723,909
"District Judge, 263rd Judicial District",0385,583,670,1253,2207,56.77%,929,248,1177
"District Judge, 263rd Judicial District",0386,662,469,1131,2922,38.71%,830,254,1084
"District Judge, 263rd Judicial District",0387,555,672,1227,3935,31.18%,895,289,1184
"District Judge, 263rd Judicial District",0388,1430,1010,2440,6888,35.42%,1417,954,2371
"District Judge, 263rd Judicial District",0389,91,208,299,1026,29.14%,42,232,274
"District Judge, 263rd Judicial District",0390,356,263,619,1480,41.82%,75,523,598
"District Judge, 263rd Judicial District",0391,508,260,768,1883,40.79%,478,256,734
"District Judge, 263rd Judicial District",0392,387,155,542,1446,37.48%,7,527,534
"District Judge, 263rd Judicial District",0393,165,185,350,1292,27.09%,171,170,341
"District Judge, 263rd Judicial District",0394,69,73,142,834,17.03%,73,62,135
"District Judge, 263rd Judicial District",0395,469,404,873,1846,47.29%,623,204,827
"District Judge, 263rd Judicial District",0396,622,216,838,2082,40.25%,17,807,824
"District Judge, 263rd Judicial District",0397,86,78,164,760,21,58%,86,72,158
"District Judge, 263rd Judicial District",0398,615,521,1136,4022,28.24%,608,497,1105
"District Judge, 263rd Judicial District",0399,402,366,768,2791,27.52%,421,321,742
"District Judge, 263rd Judicial District",0400,520,359,979,2411,40.61%,712,222,934
"District Judge, 263rd Judicial District",0401,330,205,535,1913,27.97%,19,503,522
"District Judge, 263rd Judicial District",0402,466,266,732,1794,40.80%,41,672,713
"District Judge, 263rd Judicial District",0403,475,498,973,1715,56.73%,520,367,887
"District Judge, 263rd Judicial District",0404,419,330,749,2585,28.97%,436,281,717
"District Judge, 263rd Judicial District",0405,0,0,0,0,0.00%,0,0,0
"District Judge, 263rd Judicial District",0406,137,67,204,628,32.48%,4,196,200
"District Judge, 263rd Judicial District",0407,688,793,1481,3769,39.29%,983,409,1392
"District Judge, 263rd Judicial District",0408,146,153,299,1691,17.68%,141,143,284
"District Judge, 263rd Judicial District",0409,122,149,271,1459,18.57%,112,150,262
"District Judge, 263rd Judicial District",0410,132,80,212,899,23.58%,44,157,201
"District Judge, 263rd Judicial District",0411,235,200,435,2339,18.60%,169,248,417
"District Judge, 263rd Judicial District",0412,74,44,118,468,25.21%,6,109,115
"District Judge, 263rd Judicial District",0413,767,386,1153,2992,38.54%,466,638,1104
"District Judge, 263rd Judicial District",0414,654,480,1134,3453,32.84%,889,202,1091
"District Judge, 263rd Judicial District",0415,539,598,1137,2203,51.61%,754,329,1083
"District Judge, 263rd Judicial District",0416,538,558,1096,3791,28.91%,622,432,1054
"District Judge, 263rd Judicial District",0417,353,385,738,2448,30.15%,376,328,704
"District Judge, 263rd Judicial District",0418,403,469,872,3584,24.33%,366,463,829
"District Judge, 263rd Judicial District",0419,571,324,895,2658,33.67%,606,250,856
"District Judge, 263rd Judicial District",0420,1036,874,1910,4762,40.11%,1565,273,1838
"District Judge, 263rd Judicial District",0421,35,37,73,410,17.80%,26,42,68
"District Judge, 263rd Judicial District",0422,731,402,1133,3345,33.87%,32,1078,1110
"District Judge, 263rd Judicial District",0423,108,120,228,1376,16.57%,78,141,219
"District Judge, 263rd Judicial District",0424,240,111,351,967,36.30%,203,132,335
"District Judge, 263rd Judicial District",0425,107,123,230,883,26.05%,89,131,220
"District Judge, 263rd Judicial District",0426,260,183,443,1218,36.37%,259,160,419
"District Judge, 263rd Judicial District",0427,179,134,313,1092,28.66%,136,154,290
"District Judge, 263rd Judicial District",0428,619,421,1040,4538,22.92%,331,628,959
"District Judge, 263rd Judicial District",0429,445,314,759,3197,23.74%,218,500,718
"District Judge, 263rd Judicial District",0430,161,133,294,1657,17.74%,87,192,279
"District Judge, 263rd Judicial District",0431,327,84,411,3417,12.03%,150,239,389
"District Judge, 263rd Judicial District",0432,123,157,280,1455,19.24%,108,163,271
"District Judge, 263rd Judicial District",0433,50,63,113,581,19.45%,26,83,109
"District Judge, 263rd Judicial District",0434,370,289,659,1503,43.85%,403,218,621
"District Judge, 263rd Judicial District",0435,855,636,1491,3252,45.85%,940,472,1412
"District Judge, 263rd Judicial District",0436,629,531,1160,2933,39.55%,706,388,1094
"District Judge, 263rd Judicial District",0437,521,512,1033,2033,50.81%,711,258,969
"District Judge, 263rd Judicial District",0438,617,389,1006,1861,54.06%,733,213,946
"District Judge, 263rd Judicial District",0439,710,884,1594,3554,44.85%,1108,390,1498
"District Judge, 263rd Judicial District",0440,664,858,1522,2930,51.95%,1184,243,1427
"District Judge, 263rd Judicial District",0441,345,420,765,1669,45.84%,570,152,722
"District Judge, 263rd Judicial District",0442,612,574,1186,2575,46.06%,968,173,1141
"District Judge, 263rd Judicial District",0443,226,138,364,646,56.35%,253,89,342
"District Judge, 263rd Judicial District",0444,687,583,1270,3262,38.93%,796,399,1195
"District Judge, 263rd Judicial District",0445,499,348,847,2026,41.81%,563,246,809
"District Judge, 263rd Judicial District",0446,31,22,53,291,18.21%,24,24,48
"District Judge, 263rd Judicial District",0447,93,86,179,637,28.10%,54,116,170
"District Judge, 263rd Judicial District",0448,590,778,1368,3138,43.59%,760,520,1280
"District Judge, 263rd Judicial District",0449,12,23,35,198,17.68%,3,32,35
"District Judge, 263rd Judicial District",0450,435,328,763,2635,28.96%,233,502,735
"District Judge, 263rd Judicial District",0451,1002,510,1512,2687,56.27%,1215,226,1441
"District Judge, 263rd Judicial District",0452,554,444,998,3048,32.74%,740,224,964
"District Judge, 263rd Judicial District",0453,231,262,493,1937,25.45%,197,270,467
"District Judge, 263rd Judicial District",0454,594,248,842,2561,32.88%,13,817,830
"District Judge, 263rd Judicial District",0455,367,165,532,1689,31.50%,23,503,526
"District Judge, 263rd Judicial District",0456,482,362,844,3513,24.03%,498,320,818
"District Judge, 263rd Judicial District",0457,0,0,0,0,0.00%,0,0,0
"District Judge, 263rd Judicial District",0458,471,237,708,1924,36.80%,34,650,684
"District Judge, 263rd Judicial District",0459,951,474,1425,3021,47.17%,1129,251,1380
"District Judge, 263rd Judicial District",0460,554,331,885,2837,31.19%,236,629,865
"District Judge, 263rd Judicial District",0461,1165,735,1900,3871,49.08%,1276,496,1772
"District Judge, 263rd Judicial District",0462,674,619,1293,3384,38.21%,472,762,1234
"District Judge, 263rd Judicial District",0463,480,404,884,3326,26.58%,410,443,853
"District Judge, 263rd Judicial District",0464,356,430,786,2257,34.82%,560,198,758
"District Judge, 263rd Judicial District",0465,687,520,1207,3564,33.87%,685,483,1168
"District Judge, 263rd Judicial District",0466,1058,614,1672,4184,39.96%,979,637,1616
"District Judge, 263rd Judicial District",0467,213,189,402,1270,31.65%,101,291,392
"District Judge, 263rd Judicial District",0468,352,443,795,3598,22.10%,260,502,762
"District Judge, 263rd Judicial District",0469,1294,547,1841,3985,46.20%,1436,321,1757
"District Judge, 263rd Judicial District",0470,185,176,361,1326,27.22%,266,76,342
"District Judge, 263rd Judicial District",0471,375,380,755,2387,31.63%,610,127,737
"District Judge, 263rd Judicial District",0472,198,278,476,1081,44.03%,181,252,433
"District Judge, 263rd Judicial District",0473,599,391,990,1806,54.82%,680,264,944
"District Judge, 263rd Judicial District",0474,559,588,1147,3037,37.77%,807,297,1104
"District Judge, 263rd Judicial District",0475,189,267,456,1809,25.21%,221,213,434
"District Judge, 263rd Judicial District",0476,404,473,877,2430,36.09%,497,346,843
"District Judge, 263rd Judicial District",0477,737,567,1304,3505,37.20%,996,258,1254
"District Judge, 263rd Judicial District",0478,958,657,1615,4461,36.20%,1087,452,1539
"District Judge, 263rd Judicial District",0479,638,612,1250,2714,46.06%,922,274,1196
"District Judge, 263rd Judicial District",0480,493,450,943,2415,39.05%,677,225,902
"District Judge, 263rd Judicial District",0481,770,623,1393,3482,40.01%,1074,263,1337
"District Judge, 263rd Judicial District",0482,878,630,1508,4373,34.48%,1081,373,1454
"District Judge, 263rd Judicial District",0483,1042,478,1520,4308,35.28%,880,579,1459
"District Judge, 263rd Judicial District",0484,1107,930,2037,4979,40.91%,1475,493,1968
"District Judge, 263rd Judicial District",0485,1095,911,2006,5388,37.23%,1566,384,1950
"District Judge, 263rd Judicial District",0486,873,855,1728,3866,44.70%,1352,305,1657
"District Judge, 263rd Judicial District",0487,570,294,864,3860,22.38%,320,475,795
"District Judge, 263rd Judicial District",0488,268,254,522,1719,30.37%,202,281,483
"District Judge, 263rd Judicial District",0489,350,290,640,1893,33.81%,215,392,607
"District Judge, 263rd Judicial District",0490,444,368,812,1975,41.11%,283,495,778
"District Judge, 263rd Judicial District",0491,314,372,686,1888,36.33%,409,244,653
"District Judge, 263rd Judicial District",0492,556,410,966,2335,41.37%,574,349,923
"District Judge, 263rd Judicial District",0493,479,322,801,1853,43.23%,546,206,752
"District Judge, 263rd Judicial District",0494,381,247,628,2467,25.46%,85,527,612
"District Judge, 263rd Judicial District",0495,522,523,1045,2375,44.00%,755,229,984
"District Judge, 263rd Judicial District",0496,190,315,505,2160,23.38%,206,281,487
"District Judge, 263rd Judicial District",0497,526,243,769,2257,34.07%,28,721,749
"District Judge, 263rd Judicial District",0498,363,323,686,2297,29.87%,309,358,667
"District Judge, 263rd Judicial District",0499,750,518,1268,2326,54.51%,918,280,1198
"District Judge, 263rd Judicial District",0500,729,715,1444,3507,41.17%,998,393,1391
"District Judge, 263rd Judicial District",0501,341,417,758,1801,42.09%,270,433,703
"District Judge, 263rd Judicial District",0502,477,350,827,2501,33.07%,675,122,797
"District Judge, 263rd Judicial District",0503,174,116,290,1374,21.11%,110,159,269
"District Judge, 263rd Judicial District",0504,624,527,1151,2288,50.31%,724,359,1083
"District Judge, 263rd Judicial District",0505,531,562,1193,3773,31.62%,551,567,1118
"District Judge, 263rd Judicial District",0506,665,670,1335,3502,38.12%,248,1039,1287
"District Judge, 263rd Judicial District",0507,221,149,370,2452,15.09%,78,223,301
"District Judge, 263rd Judicial District",0508,492,412,904,3287,27.50%,358,480,838
"District Judge, 263rd Judicial District",0509,753,596,1349,3732,36.15%,948,335,1283
"District Judge, 263rd Judicial District",0510,687,514,1201,3590,33.45%,600,545,1145
"District Judge, 263rd Judicial District",0511,0,0,0,0,0.00%,0,0,0
"District Judge, 263rd Judicial District",0512,602,660,1262,5057,24.96%,618,610,1228
"District Judge, 263rd Judicial District",0513,1019,487,1506,2894,52.04%,1136,297,1433
"District Judge, 263rd Judicial District",0514,953,720,1673,4275,39.13%,1276,331,1607
"District Judge, 263rd Judicial District",0515,942,683,1625,3455,47.03%,1304,247,1551
"District Judge, 263rd Judicial District",0516,1000,800,1800,5356,33.61%,957,765,1722
"District Judge, 263rd Judicial District",0517,481,256,737,2954,24.95%,424,289,713
"District Judge, 263rd Judicial District",0518,635,693,1328,3943,33.68%,877,394,1271
"District Judge, 263rd Judicial District",0519,623,493,1116,2966,37.63%,834,241,1075
"District Judge, 263rd Judicial District",0520,473,457,930,4580,20.31%,174,732,906
"District Judge, 263rd Judicial District",0521,471,464,935,2866,32.62%,512,388,900
"District Judge, 263rd Judicial District",0522,715,572,1288,2689,47.90%,997,244,1241
"District Judge, 263rd Judicial District",0523,751,415,1166,3052,38.20%,796,318,1114
"District Judge, 263rd Judicial District",0524,567,459,1026,3410,30.09%,355,636,991
"District Judge, 263rd Judicial District",0525,707,482,1189,3091,38.47%,267,866,1133
"District Judge, 263rd Judicial District",0526,68,84,152,780,19.49%,45,96,141
"District Judge, 263rd Judicial District",0527,37,40,77,574,13.41%,43,32,75
"District Judge, 263rd Judicial District",0528,14,12,26,90,28.89%,3,22,25
"District Judge, 263rd Judicial District",0529,1043,491,1534,3710,41.35%,1322,152,1474
"District Judge, 263rd Judicial District",0530,114,107,221,1196,18.48%,55,150,205
"District Judge, 263rd Judicial District",0531,363,174,537,1145,46.90%,418,98,516
"District Judge, 263rd Judicial District",0532,205,146,351,1048,33.49%,256,85,341
"District Judge, 263rd Judicial District",0533,124,108,232,1119,20.73%,137,86,223
"District Judge, 263rd Judicial District",0534,783,524,1307,3837,34.06%,999,253,1252
"District Judge, 263rd Judicial District",0535,33,29,62,416,14.90%,31,30,61
"District Judge, 263rd Judicial District",0536,554,780,1334,5139,25.96%,528,760,1288
"District Judge, 263rd Judicial District",0537,855,778,1633,3050,53.54%,1202,356,1558
"District Judge, 263rd Judicial District",0538,204,160,364,1303,27.94%,5,351,356
"District Judge, 263rd Judicial District",0539,15,241,256,64,400.00%,74,163,237
"District Judge, 263rd Judicial District",0540,378,316,694,1567,44.29%,246,394,640
"District Judge, 263rd Judicial District",0541,784,505,1289,4599,28.03%,189,1046,1235
"District Judge, 263rd Judicial District",0542,360,382,742,2557,29.02%,48,663,711
"District Judge, 263rd Judicial District",0543,141,213,354,1565,22.62%,123,208,331
"District Judge, 263rd Judicial District",0544,35,41,77,310,24.84%,11,65,76
"District Judge, 263rd Judicial District",0545,596,620,1216,3629,33.51%,625,544,1169
"District Judge, 263rd Judicial District",0546,2,2,4,37,10.81%,3,0,3
"District Judge, 263rd Judicial District",0547,501,466,967,2406,40.19%,690,236,926
"District Judge, 263rd Judicial District",0548,286,293,579,2215,26.14%,311,250,561
"District Judge, 263rd Judicial District",0549,343,418,761,2663,28.58%,116,632,748
"District Judge, 263rd Judicial District",0550,501,431,932,3031,30.75%,543,357,900
"District Judge, 263rd Judicial District",0551,1288,1394,2682,7034,38.13%,2026,576,2602
"District Judge, 263rd Judicial District",0552,847,883,1730,3415,50.66%,1434,242,1676
"District Judge, 263rd Judicial District",0553,578,529,1107,4686,23.62%,516,555,1071
"District Judge, 263rd Judicial District",0554,261,199,460,1757,26.18%,97,330,427
"District Judge, 263rd Judicial District",0555,225,277,502,2219,22.62%,104,380,484
"District Judge, 263rd Judicial District",0556,276,186,462,2319,19.92%,135,307,442
"District Judge, 263rd Judicial District",0557,455,183,638,2830,22.54%,265,292,557
"District Judge, 263rd Judicial District",0558,693,463,1156,4380,26.39%,417,694,1111
"District Judge, 263rd Judicial District",0559,640,494,1134,4969,22.82%,344,747,1091
"District Judge, 263rd Judicial District",0560,72,131,203,1120,18.13%,56,132,188
"District Judge, 263rd Judicial District",0561,362,436,798,3064,26.04%,491,279,770
"District Judge, 263rd Judicial District",0562,113,68,181,694,26.08%,26,151,177
"District Judge, 263rd Judicial District",0563,1107,376,1483,3105,47.76%,1155,262,1417
"District Judge, 263rd Judicial District",0564,470,426,896,3155,28.40%,232,621,853
"District Judge, 263rd Judicial District",0565,108,78,186,1354,13.74%,46,126,172
"District Judge, 263rd Judicial District",0566,417,324,741,2882,25.71%,236,480,716
"District Judge, 263rd Judicial District",0567,301,193,494,2238,22.07%,163,285,448
"District Judge, 263rd Judicial District",0568,876,685,1561,3594,43.43%,1018,447,1465
"District Judge, 263rd Judicial District",0569,572,667,1239,3525,35.15%,644,518,1162
"District Judge, 263rd Judicial District",0570,238,210,448,1562,28.68%,149,263,412
"District Judge, 263rd Judicial District",0571,155,149,304,1827,16.64%,127,168,295
"District Judge, 263rd Judicial District",0572,555,375,930,3108,29.92%,480,405,885
"District Judge, 263rd Judicial District",0573,290,151,441,1619,27.24%,8,426,434
"District Judge, 263rd Judicial District",0574,31,42,73,402,18.16%,10,63,73
"District Judge, 263rd Judicial District",0575,13,11,24,74,32.43%,19,4,23
"District Judge, 263rd Judicial District",0576,485,318,803,2734,29.37%,24,762,786
"District Judge, 263rd Judicial District",0577,147,88,235,608,38.65%,144,83,227
"District Judge, 263rd Judicial District",0578,409,538,947,1799,52.64%,560,336,896
"District Judge, 263rd Judicial District",0579,75,101,176,1056,16.67%,36,131,167
"District Judge, 263rd Judicial District",0580,179,118,297,1031,28.81%,4,284,288
"District Judge, 263rd Judicial District",0581,212,174,386,1032,37.40%,7,369,376
"District Judge, 263rd Judicial District",0582,258,171,429,1588,27.02%,24,392,416
"District Judge, 263rd Judicial District",0583,225,131,356,1262,28.21%,13,333,346
"District Judge, 263rd Judicial District",0584,182,93,275,1014,27.12%,10,257,267
"District Judge, 263rd Judicial District",0585,417,172,589,2511,23.46%,17,562,579
"District Judge, 263rd Judicial District",0586,638,680,1318,4316,30.54%,803,464,1267
"District Judge, 263rd Judicial District",0587,436,284,720,2598,27.71%,285,414,699
"District Judge, 263rd Judicial District",0588,758,674,1432,3645,39.29%,1027,356,1383
"District Judge, 263rd Judicial District",0589,500,386,886,3420,25.91%,497,361,858
"District Judge, 263rd Judicial District",0590,772,399,1171,2162,54.16%,891,236,1127
"District Judge, 263rd Judicial District",0591,183,231,414,2121,19.52%,128,269,397
"District Judge, 263rd Judicial District",0592,133,157,290,1350,21.48%,78,199,277
"District Judge, 263rd Judicial District",0593,543,564,1107,4380,25.27%,548,502,1050
"District Judge, 263rd Judicial District",0594,561,326,887,2490,35.62%,247,608,855
"District Judge, 263rd Judicial District",0595,201,178,379,1693,22.39%,74,298,372
"District Judge, 263rd Judicial District",0596,441,348,789,3007,26.24%,444,319,763
"District Judge, 263rd Judicial District",0597,367,394,761,3653,20.83%,335,413,748
"District Judge, 263rd Judicial District",0598,195,57,252,728,34.62%,204,42,246
"District Judge, 263rd Judicial District",0599,850,578,1428,4950,28.85%,519,866,1385
"District Judge, 263rd Judicial District",0600,667,429,1096,3957,27.70%,452,594,1046
"District Judge, 263rd Judicial District",0601,1073,756,1829,4057,45.08%,1389,375,1764
"District Judge, 263rd Judicial District",0602,293,235,528,1326,39.82%,388,126,514
"District Judge, 263rd Judicial District",0603,554,794,1678,4843,34.65%,1078,559,1637
"District Judge, 263rd Judicial District",0604,702,518,1220,3005,40.60%,1015,167,1182
"District Judge, 263rd Judicial District",0605,907,556,1463,5582,26.21%,378,1042,1420
"District Judge, 263rd Judicial District",0606,176,70,246,937,26.25%,4,239,243
"District Judge, 263rd Judicial District",0607,52,51,113,728,15.52%,12,96,108
"District Judge, 263rd Judicial District",0608,31,47,78,537,14.53%,47,26,73
"District Judge, 263rd Judicial District",0609,557,680,1347,3384,39.80%,835,439,1274
"District Judge, 263rd Judicial District",0610,231,188,419,1927,21.74%,218,168,386
"District Judge, 263rd Judicial District",0611,495,242,737,2488,29.62%,24,696,720
"District Judge, 263rd Judicial District",0612,996,497,1493,3307,45.15%,1123,287,1410
"District Judge, 263rd Judicial District",0613,186,204,390,1554,25.10%,65,313,378
"District Judge, 263rd Judicial District",0614,737,566,1303,4207,30.97%,504,747,1251
"District Judge, 263rd Judicial District",0615,450,299,779,1967,39.60%,498,261,759
"District Judge, 263rd Judicial District",0616,739,663,1402,3436,40.80%,987,362,1349
"District Judge, 263rd Judicial District",0617,541,393,934,3809,24.52%,393,520,913
"District Judge, 263rd Judicial District",0618,946,567,1513,6003,25.20%,774,690,1464
"District Judge, 263rd Judicial District",0619,1219,803,2022,4297,47.06%,1509,417,1926
"District Judge, 263rd Judicial District",0620,589,264,953,2897,32.90%,594,316,910
"District Judge, 263rd Judicial District",0621,154,101,255,1133,22.51%,133,106,239
"District Judge, 263rd Judicial District",0622,881,524,1405,4403,31.91%,874,482,1356
"District Judge, 263rd Judicial District",0623,887,487,1374,3691,37.23%,933,379,1312
"District Judge, 263rd Judicial District",0624,1,1,2,3,66.67%,1,1,2
"District Judge, 263rd Judicial District",0625,477,362,839,1820,46.10%,477,315,792
"District Judge, 263rd Judicial District",0626,551,440,1021,2861,35.69%,554,405,959
"District Judge, 263rd Judicial District",0627,345,322,668,3049,21.91%,247,389,636
"District Judge, 263rd Judicial District",0628,152,219,371,1675,22.15%,199,160,359
"District Judge, 263rd Judicial District",0629,37,53,90,696,12.93%,15,74,89
"District Judge, 263rd Judicial District",0630,974,600,1574,3905,40.31%,130,1400,1530
"District Judge, 263rd Judicial District",0631,822,404,1226,2846,43.08%,896,283,1179
"District Judge, 263rd Judicial District",0632,7,4,11,343,3.21%,3,8,11
"District Judge, 263rd Judicial District",0633,943,731,1674,3559,47.04%,1197,415,1612
"District Judge, 263rd Judicial District",0634,458,442,900,3029,29.71%,596,273,869
"District Judge, 263rd Judicial District",0635,743,485,1228,3393,36.19%,934,260,1194
"District Judge, 263rd Judicial District",0636,835,874,1710,4140,41.30%,1484,174,1658
"District Judge, 263rd Judicial District",0637,409,362,771,2512,30.69%,194,527,721
"District Judge, 263rd Judicial District",0638,304,245,549,2204,24.91%,43,482,525
"District Judge, 263rd Judicial District",0639,549,547,1096,2526,43.39%,884,168,1052
"District Judge, 263rd Judicial District",0640,641,459,1100,3733,29.47%,696,371,1067
"District Judge, 263rd Judicial District",0641,649,596,1245,3650,34.11%,831,365,1196
"District Judge, 263rd Judicial District",0642,471,394,865,1764,49.04%,700,127,827
"District Judge, 263rd Judicial District",0643,934,653,1587,5945,26.69%,633,903,1536
"District Judge, 263rd Judicial District",0644,1019,823,1842,5523,33.35%,1222,539,1761
"District Judge, 263rd Judicial District",0645,654,594,1248,4185,29.82%,677,518,1195
"District Judge, 263rd Judicial District",0646,364,287,651,2220,29.32%,214,394,608
"District Judge, 263rd Judicial District",0647,904,470,1374,6084,22.58%,400,862,1262
"District Judge, 263rd Judicial District",0648,838,579,1417,3367,42.08%,1021,350,1371
"District Judge, 263rd Judicial District",0649,687,434,1121,4576,24.50%,378,667,1045
"District Judge, 263rd Judicial District",0650,906,766,1672,3888,43.00%,1210,389,1599
"District Judge, 263rd Judicial District",0651,963,766,1729,5128,33.72%,1127,527,1654
"District Judge, 263rd Judicial District",0652,467,515,982,2815,34.88%,181,764,945
"District Judge, 263rd Judicial District",0653,0,4,4,0,0.00%,1,3,4
"District Judge, 263rd Judicial District",0654,950,1005,1955,6208,31.49%,1106,778,1884
"District Judge, 263rd Judicial District",0655,1115,1079,2195,6855,32.02%,1378,732,2110
"District Judge, 263rd Judicial District",0656,579,393,972,2674,36.35%,40,906,946
"District Judge, 263rd Judicial District",0657,246,172,418,1292,32.35%,170,232,402
"District Judge, 263rd Judicial District",0658,540,426,966,2807,34.41%,633,311,944
"District Judge, 263rd Judicial District",0659,1149,788,1937,4856,39.89%,1396,486,1882
"District Judge, 263rd Judicial District",0660,950,825,1775,5372,33.04%,168,1562,1730
"District Judge, 263rd Judicial District",0661,675,765,1440,4567,31.53%,843,536,1379
"District Judge, 263rd Judicial District",0662,1148,890,2038,4874,41.81%,1648,329,1977
"District Judge, 263rd Judicial District",0663,717,797,1514,3346,45.25%,751,654,1405
"District Judge, 263rd Judicial District",0664,352,250,602,2869,20.98%,140,434,574
"District Judge, 263rd Judicial District",0665,482,348,830,2154,38.53%,702,99,801
"District Judge, 263rd Judicial District",0666,0,0,0,0,0.00%,0,0,0
"District Judge, 263rd Judicial District",0667,488,502,990,2149,46.07%,772,177,949
"District Judge, 263rd Judicial District",0668,399,509,908,2775,32.72%,600,279,879
"District Judge, 263rd Judicial District",0669,850,738,1,588,3425,46.36%,1136,380,1516
"District Judge, 263rd Judicial District",0670,955,471,1427,2983,47.84%,1111,259,1370
"District Judge, 263rd Judicial District",0671,403,565,968,3037,31.87%,602,324,926
"District Judge, 263rd Judicial District",0672,959,862,1821,5706,31.91%,1252,519,1771
"District Judge, 263rd Judicial District",0673,729,516,1245,2995,41.57%,996,195,1191
"District Judge, 263rd Judicial District",0674,1071,618,1689,4091,41.29%,1266,358,1624
"District Judge, 263rd Judicial District",0675,0,1,1,0,0.00%,1,0,1
"District Judge, 263rd Judicial District",0676,0,0,0,0,0.00%,0,0,0
"District Judge, 263rd Judicial District",0677,127,127,254,1266,20.06%,98,142,240
"District Judge, 263rd Judicial District",0678,166,108,274,735,37.28%,180,72,252
"District Judge, 263rd Judicial District",0679,635,520,1155,3381,34.16%,884,223,1107
"District Judge, 263rd Judicial District",0680,21,14,35,162,21.60%,13,22,35
"District Judge, 263rd Judicial District",0681,1,0,1,5,20.00%,1,0,1
"District Judge, 263rd Judicial District",0682,711,654,1365,4216,32.38%,1023,296,1319
"District Judge, 263rd Judicial District",0683,29,20,49,276,17.75%,9,35,44
"District Judge, 263rd Judicial District",0684,27,22,49,223,21.97%,26,21,47
"District Judge, 263rd Judicial District",0685,110,29,139,307,45.28%,63,67,130
"District Judge, 263rd Judicial District",0686,17,12,29,208,13.94%,11,17,28
"District Judge, 263rd Judicial District",0687,549,537,1086,2609,41.63%,739,283,1022
"District Judge, 263rd Judicial District",0688,999,617,1616,3504,46.12%,1294,257,1551
"District Judge, 263rd Judicial District",0689,211,387,598,2346,25.49%,303,263,566
"District Judge, 263rd Judicial District",0690,926,1104,2030,5102,39.79%,1657,306,1963
"District Judge, 263rd Judicial District",0691,2,5,7,25,28.00%,4,3,7
"District Judge, 263rd Judicial District",0692,444,548,992,2847,34.84%,741,214,955
"District Judge, 263rd Judicial District",0693,167,91,258,666,38.74%,75,174,249
"District Judge, 263rd Judicial District",0694,260,120,380,845,44.97%,258,97,355
"District Judge, 263rd Judicial District",0695,232,193,425,1724,24.65%,274,138,412
"District Judge, 263rd Judicial District",0696,261,207,468,1982,23.61%,303,146,449
"District Judge, 263rd Judicial District",0697,605,613,1218,4413,27.60%,320,859,1179
"District Judge, 263rd Judicial District",0698,448,489,937,3189,29.38%,104,807,911
"District Judge, 263rd Judicial District",0699,568,414,982,2343,41.91%,643,277,920
"District Judge, 263rd Judicial District",0700,255,251,506,1371,36.91%,429,57,486
"District Judge, 263rd Judicial District",0701,56,43,99,588,16.84%,62,31,93
"District Judge, 263rd Judicial District",0702,54,70,134,539,24.86%,19,113,132
"District Judge, 263rd Judicial District",0703,372,490,862,1882,45.80%,625,198,823
"District Judge, 263rd Judicial District",0704,569,599,1168,3064,38.12%,964,159,1123
"District Judge, 263rd Judicial District",0705,114,113,227,1523,14.90%,34,185,219
"District Judge, 263rd Judicial District",0706,115,71,186,610,30.49%,90,83,173
"District Judge, 263rd Judicial District",0707,153,86,239,707,33.80%,153,74,227
"District Judge, 263rd Judicial District",0708,54,52,106,563,18.83%,50,50,100
"District Judge, 263rd Judicial District",0709,1375,947,2322,6848,33.91%,1416,838,2254
"District Judge, 263rd Judicial District",0710,371,462,833,2082,40.01%,457,317,774
"District Judge, 263rd Judicial District",0711,702,506,1208,3484,34.67%,732,409,1141
"District Judge, 263rd Judicial District",0712,491,463,954,3670,25.99%,414,520,934
"District Judge, 263rd Judicial District",0713,228,262,490,1907,25.69%,249,219,468
"District Judge, 263rd Judicial District",0714,35,19,55,296,18.58%,36,17,53
"District Judge, 263rd Judicial District",0715,176,187,363,1408,25.78%,206,137,343
"District Judge, 263rd Judicial District",0716,449,407,856,2680,31.94%,609,225,834
"District Judge, 263rd Judicial District",0717,373,250,623,2002,31.12%,76,533,609
"District Judge, 263rd Judicial District",0718,1017,806,1823,4229,43.11%,1263,455,1718
"District Judge, 263rd Judicial District",0719,247,137,384,1589,24.17%,235,132,367
"District Judge, 263rd Judicial District",0720,994,780,1774,4282,41.43%,1341,373,1714
"District Judge, 263rd Judicial District",0721,754,532,1286,2870,44.81%,843,382,1225
"District Judge, 263rd Judicial District",0722,871,494,1365,4479,30.48%,104,1219,1323
"District Judge, 263rd Judicial District",0723,401,202,603,1858,32.45%,135,450,585
"District Judge, 263rd Judicial District",0724,151,128,279,766,36.42%,202,62,264
"District Judge, 263rd Judicial District",0725,423,237,660,2237,29.50%,316,321,637
"District Judge, 263rd Judicial District",0726,592,402,994,2087,47.63%,875,97,972
"District Judge, 263rd Judicial District",0727,338,290,628,2488,25.24%,205,384,589
"District Judge, 263rd Judicial District",0728,209,151,360,880,40.91%,224,120,344
"District Judge, 263rd Judicial District",0729,136,59,195,464,42.03%,121,70,191
"District Judge, 263rd Judicial District",0730,428,359,787,1747,45.05%,505,235,740
"District Judge, 263rd Judicial District",0731,58,27,85,352,24.15%,25,58,83
"District Judge, 263rd Judicial District",0732,441,324,765,1924,39.76%,479,243,722
"District Judge, 263rd Judicial District",0733,13,7,20,215,9.30%,8,10,18
"District Judge, 263rd Judicial District",0734,1558,962,2520,7005,35.97%,1755,690,2445
"District Judge, 263rd Judicial District",0735,8,0,6,18,33.33%,6,0,6
"District Judge, 263rd Judicial District",0736,3,1,4,22,18.18%,0,3,3
"District Judge, 263rd Judicial District",0737,11,7,18,51,35.29%,13,5,18
"District Judge, 263rd Judicial District",0738,139,100,239,1361,17.56%,47,187,234
"District Judge, 263rd Judicial District",0739,353,301,654,2955,22.13%,341,285,626
"District Judge, 263rd Judicial District",0740,96,98,194,939,20.66%,132,55,187
"District Judge, 263rd Judicial District",0741,0,1,1,0,0.00%,0,1,1
"District Judge, 263rd Judicial District",0742,0,11,11,0,0.00%,6,5,11
"District Judge, 263rd Judicial District",0743,15,18,33,210,15.71%,19,12,31
"District Judge, 263rd Judicial District",0744,456,392,848,2027,41.84%,536,262,798
"District Judge, 263rd Judicial District",0745,683,372,1055,2494,42.30%,641,360,1001
"District Judge, 263rd Judicial District",0746,114,77,191,691,27.64%,93,95,188
"District Judge, 263rd Judicial District",0747,550,467,1017,3743,27.17%,506,480,986
"District Judge, 263rd Judicial District",0748,170,140,310,1403,22.10%,163,136,299
"District Judge, 263rd Judicial District",0749,30,17,47,377,12.47%,9,36,45
"District Judge, 263rd Judicial District",0750,111,96,207,767,26.99%,128,75,203
"District Judge, 263rd Judicial District",0751,925,964,1889,5084,37.16%,1276,538,1814
"District Judge, 263rd Judicial District",0752,286,200,486,1483,32.77%,370,95,465
"District Judge, 263rd Judicial District",0753,55,73,128,259,49.42%,80,42,122
"District Judge, 263rd Judicial District",0754,0,0,0,0,0.00%,0,0,0
"District Judge, 263rd Judicial District",0755,442,584,1026,4294,23.89%,461,522,983
"District Judge, 263rd Judicial District",0756,251,177,428,1600,26.75%,174,237,411
"District Judge, 263rd Judicial District",0757,520,508,1028,4035,25.48%,190,803,993
"District Judge, 263rd Judicial District",0758,1114,692,1806,4096,44.09%,1448,298,1746
"District Judge, 263rd Judicial District",0759,465,413,878,2730,32.16%,563,283,846
"District Judge, 263rd Judicial District",0760,1432,639,2071,4367,47.42%,1697,287,1984
"District Judge, 263rd Judicial District",0761,548,253,801,1550,51.68%,545,201,746
"District Judge, 263rd Judicial District",0762,0,0,0,0,0.00%,0,0,0
"District Judge, 263rd Judicial District",0763,108,146,254,1212,20.96%,104,138,242
"District Judge, 263rd Judicial District",0764,1133,774,1907,5217,36.55%,1218,630,1848
"District Judge, 263rd Judicial District",0765,647,426,1073,4055,26.46%,446,570,1016
"District Judge, 263rd Judicial District",0766,40,25,65,392,16.58%,17,42,59
"District Judge, 263rd Judicial District",0767,10,2,12,86,13.95%,6,6,12
"District Judge, 263rd Judicial District",0768,1359,1015,2374,5857,40.53%,1941,365,2306
"District Judge, 263rd Judicial District",0769,54,16,70,183,38.25%,3,66,69
"District Judge, 263rd Judicial District",0770,31,25,56,323,17.34%,28,26,54
"District Judge, 263rd Judicial District",0771,324,254,578,2426,23.83%,343,216,559
"District Judge, 263rd Judicial District",0772,1792,851,2643,5709,46.30%,2017,508,2525
"District Judge, 263rd Judicial District",0773,473,312,785,2918,26.90%,222,498,720
"District Judge, 263rd Judicial District",0774,30,41,71,378,18.78%,16,53,69
"District Judge, 263rd Judicial District",0775,18,3,21,92,22.83%,0,21,21
"District Judge, 263rd Judicial District",0776,551,496,1047,3053,34.29%,618,381,999
"District Judge, 263rd Judicial District",0777,46,40,86,652,13.19%,28,55,83
"District Judge, 263rd Judicial District",0778,0,0,0,0,0.00%,0,0,0
"District Judge, 263rd Judicial District",0779,64,51,115,940,12.23%,43,68,111
"District Judge, 263rd Judicial District",0780,63,59,122,595,20.50%,72,46,118
"District Judge, 263rd Judicial District",0781,666,273,939,3603,26.06%,428,411,839
"District Judge, 263rd Judicial District",0782,368,370,738,2236,33.01%,463,249,712
"District Judge, 263rd Judicial District",0783,49,13,62,294,21.09%,46,14,60
"District Judge, 263rd Judicial District",0784,208,128,336,1079,31.14%,9,313,322
"District Judge, 263rd Judicial District",0785,28,25,53,296,17.91%,29,24,53
"District Judge, 263rd Judicial District",0786,100,98,198,1251,15.83%,75,117,192
"District Judge, 263rd Judicial District",0787,46,52,98,488,20.08%,36,59,95
"District Judge, 263rd Judicial District",0788,74,32,106,454,23.35%,51,52,103
"District Judge, 263rd Judicial District",0789,0,3,3,3,100.00%,0,3,3
"District Judge, 263rd Judicial District",0790,0,0,0,3,0.00%,0,0,0
"District Judge, 263rd Judicial District",0791,0,0,0,0,0.00%,0,0,0
"District Judge, 263rd Judicial District",0792,269,239,508,1865,27.24%,127,356,483
"District Judge, 263rd Judicial District",0793,448,247,695,2484,27.98%,422,251,673
"District Judge, 263rd Judicial District",0794,124,144,268,2710,9.89%,36,226,262
"District Judge, 263rd Judicial District",0795,90,125,215,1217,17.67%,79,125,204
"District Judge, 263rd Judicial District",0796,83,51,134,476,28.15%,73,57,130
"District Judge, 263rd Judicial District",0797,0,0,0,0,0.00%,0,0,0
"District Judge, 263rd Judicial District",0798,99,111,210,500,42.00%,84,114,198
"District Judge, 263rd Judicial District",0799,28,15,43,161,26.71%,9,34,43
"District Judge, 263rd Judicial District",0800,588,642,1230,2932,41.95%,833,329,1162
"District Judge, 263rd Judicial District",0801,32,14,46,258,17.83%,15,27,42
"District Judge, 263rd Judicial District",0802,51,27,78,312,25.00%,15,62,77
"District Judge, 263rd Judicial District",0803,725,511,1236,2893,42.72%,910,283,1193
"District Judge, 263rd Judicial District",0804,932,591,1523,4768,31.94%,978,495,1473
"District Judge, 263rd Judicial District",0805,765,533,1298,2866,45.29%,1059,195,1254
"District Judge, 263rd Judicial District",0806,0,0,0,0,0.00%,0,0,0
"District Judge, 263rd Judicial District",0807,211,204,415,2028,20.46%,93,305,398
"District Judge, 263rd Judicial District",0808,12,17,29,131,22.14%,7,21,28
"District Judge, 263rd Judicial District",0809,7,6,13,92,14.13%,6,6,12
"District Judge, 263rd Judicial District",0810,9,16,25,211,11.85%,8,16,24
"District Judge, 263rd Judicial District",0811,29,50,79,270,29.26%,26,50,76
"District Judge, 263rd Judicial District",0812,0,0,0,0,0.00%,0,0,0
"District Judge, 263rd Judicial District",0813,938,761,1699,5807,29.26%,860,787,1647
"District Judge, 263rd Judicial District",0814,673,533,1206,5102,23.64%,318,854,1172
"District Judge, 263rd Judicial District",0815,0,0,0,0,0.00%,0,0,0
"District Judge, 263rd Judicial District",0816,10,0,10,73,13.70%,3,7,10
"District Judge, 263rd Judicial District",0817,0,0,0,0,0.00%,0,0,0
"District Judge, 263rd Judicial District",0818,86,39,125,616,20.29%,27,92,119
"District Judge, 263rd Judicial District",0819,64,30,94,240,39.17%,51,32,83
"District Judge, 263rd Judicial District",0820,0,0,0,0,0.00%,0,0,0
"District Judge, 263rd Judicial District",0821,124,120,244,1242,19.65%,34,200,234
"District Judge, 263rd Judicial District",0822,332,167,499,1535,32.51%,17,467,484
"District Judge, 263rd Judicial District",0823,821,564,1385,5087,27.23%,805,536,1341
"District Judge, 263rd Judicial District",0824,428,282,710,2700,26.30%,159,530,689
"District Judge, 263rd Judicial District",0825,0,0,0,0,0.00%,0,0,0
"District Judge, 263rd Judicial District",0826,73,50,123,358,34.36%,53,59,112
"District Judge, 263rd Judicial District",0827,60,98,158,979,16.14%,74,79,153
"District Judge, 263rd Judicial District",0828,541,388,929,1916,48.49%,737,150,887
"District Judge, 263rd Judicial District",0829,54,22,76,264,28.79%,20,54,74
"District Judge, 263rd Judicial District",0830,0,0,0,2,0.00%,0,0,0
"District Judge, 263rd Judicial District",0831,0,0,0,0,0.00%,0,0,0
"District Judge, 263rd Judicial District",0832,34,28,62,352,17.61%,18,40,58
"District Judge, 263rd Judicial District",0833,0,1,1,20,5.00%,0,1,1
"District Judge, 263rd Judicial District",0834,0,0,0,0,0.00%,0,0,0
"District Judge, 263rd Judicial District",0835,38,19,57,290,19.66%,13,38,51
"District Judge, 263rd Judicial District",0836,3,0,3,19,15.79%,1,2,3
"District Judge, 263rd Judicial District",0837,0,0,0,0,0.00%,0,0,0
"District Judge, 263rd Judicial District",0838,0,0,0,0,0.00%,0,0,0
"District Judge, 263rd Judicial District",0839,136,118,254,1128,22.52%,54,188,242
"District Judge, 263rd Judicial District",0840,381,174,555,1705,32.55%,196,343,539
"District Judge, 263rd Judicial District",0841,0,0,0,0,0.00%,0,0,0
"District Judge, 263rd Judicial District",0842,421,434,855,3259,26.24%,398,421,819
"District Judge, 263rd Judicial District",0843,0,1,1,0,0.00%,0,1,1
"District Judge, 263rd Judicial District",0844,1,0,1,11,9.09%,0,1,1
"District Judge, 263rd Judicial District",0845,54,9,63,134,47.01%,39,21,60
"District Judge, 263rd Judicial District",0846,23,24,47,229,20.52%,2,42,44
"District Judge, 263rd Judicial District",0847,305,211,516,2015,25.61%,142,354,496
"District Judge, 263rd Judicial District",0848,489,266,755,1856,40.68%,222,496,718
"District Judge, 263rd Judicial District",0849,201,291,492,2124,23.16%,197,277,474
"District Judge, 263rd Judicial District",0850,46,41,87,210,41.43%,33,52,85
"District Judge, 263rd Judicial District",0851,1029,657,1686,4709,35.80%,1148,467,1615
"District Judge, 263rd Judicial District",0852,0,0,0,1,0.00%,0,0,0
"District Judge, 263rd Judicial District",0853,575,620,1296,2882,44.97%,992,248,1240
"District Judge, 263rd Judicial District",0854,15,26,41,172,23.84%,9,30,39
"District Judge, 263rd Judicial District",0855,5,9,14,16,87.50%,5,8,13
"District Judge, 263rd Judicial District",0856,0,1,1,0,0.00%,0,1,1
"District Judge, 263rd Judicial District",0857,0,0,0,1,0.00%,0,0,0
"District Judge, 263rd Judicial District",0858,63,34,97,343,28.28%,3,90,93
"District Judge, 263rd Judicial District",0859,157,106,283,890,29.55%,70,185,255
"District Judge, 263rd Judicial District",0880,0,0,0,0,0.00%,0,0,0
"District Judge, 263rd Judicial District",0881,315,199,514,1842,27.90%,87,414,501
"District Judge, 263rd Judicial District",0882,0,0,0,0,0.00%,0,0,0
"District Judge, 263rd Judicial District",0883,101,54,155,584,28.54%,8,148,154
"District Judge, 263rd Judicial District",0884,193,299,492,2589,19.15%,145,323,488
"District Judge, 263rd Judicial District",0885,2,3,5,21,23.81%,0,5,5
"District Judge, 263rd Judicial District",0888,0,0,0,0,0.00%,0,0,0
"District Judge, 263rd Judicial District",0887,0,0,0,0,0.00%,0,0,0
"District Judge, 263rd Judicial District",0888,238,271,507,2328,21.80%,188,318,484
"District Judge, 263rd Judicial District",0889,53,39,92,470,19.57%,22,89,91
"District Judge, 263rd Judicial District",0870,0,0,0,0,0.00%,0,0,0
"District Judge, 263rd Judicial District",0871,1,0,1,3,33.33%,0,1,1
"District Judge, 263rd Judicial District",0872,5,3,8,59,13.58%,4,4,8
"District Judge, 263rd Judicial District",0873,98,75,173,737,23.47%,44,125,189
"District Judge, 263rd Judicial District",0874,783,707,1470,3223,45.81%,1102,310,1412
"District Judge, 263rd Judicial District",0875,904,527,1431,5147,27.80%,703,879,1382
"District Judge, 263rd Judicial District",0878,898,841,1339,3285,41.01%,1030,289,1299
"District Judge, 263rd Judicial District",0877,478,382,858,3032,28.30%,354,483,837
"District Judge, 263rd Judicial District",0878,427,354,781,1888,48.88%,848,114,782
"District Judge, 263rd Judicial District",0879,407,294,701,2887,28.28%,383,307,870
"District Judge, 263rd Judicial District",0880,543,447,990,2352,42.09%,793,188,959
"District Judge, 263rd Judicial District",0881,593,540,1133,4479,25.30%,405,700,1105
"District Judge, 263rd Judicial District",0882,428,291,717,2422,29.80%,434,259,893
"District Judge, 263rd Judicial District",0883,843,702,1345,5408,24.87%,254,1047,1301
"District Judge, 263rd Judicial District",0884,57,25,82,377,21.75%,9,70,79
"District Judge, 263rd Judicial District",0885,562,388,930,2819,35.51%,555,354,909
"District Judge, 263rd Judicial District",0888,128,108,238,875,34.98%,129,95,224
"District Judge, 263rd Judicial District",0887,50,87,117,418,27.99%,53,53,108
"District Judge, 263rd Judicial District",0888,0,3,3,0,0.00%,2,1,3
"District Judge, 263rd Judicial District",0889,14,0,14,57,24.58%,5,8,13
"District Judge, 263rd Judicial District",0890,184,103,287,1095,24.38%,82,183,245
"District Judge, 263rd Judicial District",0891,317,243,580,1331,42.07%,194,330,524
"District Judge, 263rd Judicial District",0892,115,86,201,808,24.88%,72,117,189
"District Judge, 263rd Judicial District",0893,0,2,2,6,33.33%,0,2,2
"District Judge, 263rd Judicial District",0894,0,3,3,0,0.00%,2,1,3
"District Judge, 263rd Judicial District",0895,156,286,442,793,55.74%,158,237,395
"District Judge, 263rd Judicial District",0896,370,297,667,1459,45.72%,231,392,623
"District Judge, 263rd Judicial District",0897,252,297,549,1701,32.28%,322,206,528
"District Judge, 263rd Judicial District",0898,0,0,0,3,0.00%,0,0,0
"District Judge, 263rd Judicial District",0899,2,0,2,8,25.00%,0,2,2
"District Judge, 263rd Judicial District",0900,0,2,2,10,20.00%,1,1,2
"District Judge, 263rd Judicial District",0901,0,0,0,0,0.00%,0,0,0
"District Judge, 263rd Judicial District",0902,394,486,880,2139,41.14%,474,353,827
"District Judge, 263rd Judicial District",0903,3,7,10,50,20.00%,2,7,9
"District Judge, 263rd Judicial District",0904,1,0,1,7,14.29%,1,0,1
"District Judge, 263rd Judicial District",0905,123,100,223,904,24.67%,104,105,209
"District Judge, 263rd Judicial District",0906,8,6,14,25,56.00%,7,5,12
"District Judge, 263rd Judicial District",0907,12,19,31,181,17.13%,6,25,31
"District Judge, 263rd Judicial District",0908,0,1,1,0,0.00%,0,1,1
"District Judge, 263rd Judicial District",0909,2,1,3,18,16.67%,0,3,3
"District Judge, 263rd Judicial District",0910,25,24,49,217,22.58%,20,25,45
"District Judge, 263rd Judicial District",0911,118,60,178,551,32.30%,120,51,171
"District Judge, 263rd Judicial District",0912,316,201,517,1273,40.61%,338,152,490
"District Judge, 263rd Judicial District",0913,0,0,0,0,0.00%,0,0,0
"District Judge, 263rd Judicial District",0914,169,179,348,701,49.64%,279,56,335
"District Judge, 263rd Judicial District",0915,0,0,0,0,0.00%,0,0,0
"District Judge, 263rd Judicial District",0916,417,240,657,1491,44.06%,525,111,636
"District Judge, 263rd Judicial District",0917,177,62,239,483,49.48%,157,67,224
"District Judge, 263rd Judicial District",0918,304,168,472,883,53.45%,351,99,450
"District Judge, 263rd Judicial District",0919,0,0,0,3,0.00%,0,0,0
"District Judge, 263rd Judicial District",0920,22,12,34,71,47.89%,23,10,33
"District Judge, 263rd Judicial District",0921,32,15,47,119,39.50%,33,13,46
"District Judge, 263rd Judicial District",0922,0,0,0,0,0.00%,0,0,0
"District Judge, 263rd Judicial District",0923,470,137,607,1511,40.17%,453,135,588
"District Judge, 263rd Judicial District",0924,0,0,0,0,0.00%,0,0,0
"District Judge, 263rd Judicial District",0925,0,0,0,0,0.00%,0,0,0
"District Judge, 263rd Judicial District",0926,171,128,299,796,37.56%,226,62,288
"District Judge, 263rd Judicial District",0927,44,30,74,270,27.41%,29,38,67
"District Judge, 263rd Judicial District",0928,3,0,3,8,37.50%,0,3,3
"District Judge, 263rd Judicial District",0929,0,0,0,0,0.00%,0,0,0
"District Judge, 263rd Judicial District",0930,109,54,163,584,27.91%,6,153,159
"District Judge, 263rd Judicial District",0931,30,40,70,130,53.85%,30,31,61
"District Judge, 263rd Judicial District",0932,0,0,0,0,0.00%,0,0,0
"District Judge, 263rd Judicial District",0933,115,85,200,627,31.90%,57,138,195
"District Judge, 263rd Judicial District",0934,2,0,2,63,3.17%,1,1,2
"District Judge, 263rd Judicial District",0935,3,2,5,54,9.26%,2,1,3
"District Judge, 263rd Judicial District",0936,s,2,10,81,12.35%,3,6,9
"District Judge, 263rd Judicial District",0937,0,0,0,0,0.00%,0,0,0
"District Judge, 263rd Judicial District",0938,30,14,44,231,19.05%,13,29,42
"District Judge, 263rd Judicial District",0939,0,0,0,2,0.00%,0,0,0
"District Judge, 263rd Judicial District",0940,0,0,0,10,0.00%,0,0,0
"District Judge, 263rd Judicial District",0941,9,10,19,25,76.00%,17,2,19
"District Judge, 263rd Judicial District",0942,53,27,80,156,51.28%,66,12,78
"District Judge, 263rd Judicial District",0943,164,80,244,547,44.61%,157,70,227
"District Judge, 263rd Judicial District",0944,20,4,24,45,53.33%,18,1,19
"District Judge, 263rd Judicial District",0945,1,2,3,17,17.65%,1,2,3
"District Judge, 263rd Judicial District",0946,0,1,1,13,7.69%,0,1,1
"District Judge, 263rd Judicial District",0947,177,246,423,799,52.94%,217,183,400
"District Judge, 263rd Judicial District",0948,0,14,14,1,1400.00%,9,2,11
"District Judge, 263rd Judicial District",0949,34,27,61,193,31.61%,32,29,61
"District Judge, 263rd Judicial District",0950,0,0,0,1,0.00%,0,0,0
"District Judge, 263rd Judicial District",0951,33,30,63,277,22.74%,18,43,61
"District Judge, 263rd Judicial District",0952,16,15,31,71,43.66%,15,13,28
"District Judge, 263rd Judicial District",0953,18,9,27,275,9.82%,5,22,27
"District Judge, 263rd Judicial District",0954,0,0,0,1,0.00%,0,0,0
"District Judge, 263rd Judicial District",0955,3,2,5,19,26.32%,4,1,5
"District Judge, 263rd Judicial District",0956,2,4,6,11,54.55%,2,4,6
"District Judge, 263rd Judicial District",0957,97,95,192,562,34.16%,22,167,189
"District Judge, 263rd Judicial District",0958,81,129,210,1081,19.43%,53,151,204
"District Judge, 263rd Judicial District",0959,0,0,0,0,0.00%,0,0,0
"District Judge, 263rd Judicial District",0960,196,157,353,976,36.17%,71,267,338
"District Judge, 263rd Judicial District",0961,15,0,16,56,28.57%,0,15,15
"District Judge, 263rd Judicial District",0962,10,17,27,88,30.68%,3,24,27
"District Judge, 263rd Judicial District",0963,54,41,105,426,24.65%,56,43,99
"District Judge, 263rd Judicial District",0964,568,437,1005,2372,42.37%,612,359,971
"District Judge, 263rd Judicial District",0965,31,21,52,343,15.16%,27,25,52
"District Judge, 263rd Judicial District",0966,129,83,212,1148,18.47%,79,128,207
"District Judge, 263rd Judicial District",0967,15,48,63,165,38.18%,19,43,62
"District Judge, 263rd Judicial District",0968,119,30,149,692,21.53%,30,116,146
"District Judge, 263rd Judicial District",0969,156,73,229,604,37.91%,1,225,226
"District Judge, 263rd Judicial District",0970,83,36,119,731,16.28%,18,97,115
"District Judge, 263rd Judicial District",0971,11,8,19,147,12.93%,1,16,17
"District Judge, 263rd Judicial District",09726,8,14,31,45.16%,13,0,13
"District Judge, 263rd Judicial District",0973,24,19,43,111,38.74%,19,20,39
"District Judge, 263rd Judicial District",0974,57,36,93,299,31.10%,59,32,91
"District Judge, 263rd Judicial District",0975,55,30,85,193,44.04%,39,39,78
"District Judge, 263rd Judicial District",0976,58,62,130,683,19.03%,86,42,128
"District Judge, 263rd Judicial District",0977,50,43,93,572,16.26%,42,51,93
"District Judge, 263rd Judicial District",0978,77,79,156,546,28.57%,29,124,153
"District Judge, 263rd Judicial District",0979,2,6,8,27,29.63%,4,3,7
"District Judge, 263rd Judicial District",0980,280,321,601,1389,43.27%,447,125,572
"District Judge, 263rd Judicial District",0981,0,0,0,0,0.00%,0,0,0
"District Judge, 263rd Judicial District",0982,312,312,624,1567,39.82%,510,89,599
"District Judge, 263rd Judicial District",0983,11,21,32,161,19.88%,20,11,31
"District Judge, 263rd Judicial District",0984,18,9,27,192,14.06%,4,22,26
"District Judge, 263rd Judicial District",0985,117,63,180,351,51.28%,98,70,168
"District Judge, 263rd Judicial District",0986,43,30,73,463,15.77%,12,60,72
"District Judge, 263rd Judicial District",0987,231,90,321,1155,27.79%,28,283,311
"District Judge, 263rd Judicial District",0988,24,12,36,123,29.27%,33,3,36
"District Judge, 263rd Judicial District",09896,6,12,43,27.91%,9,3,12
"District Judge, 263rd Judicial District",0990,16,1,17,140,12.14%,8,8,16
"District Judge, 263rd Judicial District",0991,0,0,0,1,0.00%,0,0,0
"District Judge, 263rd Judicial District",0992,157,107,264,1048,25.19%,144,106,250
"District Judge, 263rd Judicial District",0993,169,101,270,568,47.54%,219,41,260
"District Judge, 263rd Judicial District",0994,5,5,11,25,44.00%,2,9,11
"District Judge, 263rd Judicial District",0995,295,156,451,1393,32.38%,29,413,442
"District Judge, 263rd Judicial District",0996,135,140,275,694,39.63%,159,96,255
"District Judge, 263rd Judicial District",0997,101,163,264,1656,15.94%,58,202,260
"District Judge, 263rd Judicial District",0998,5,1,6,57,10.53%,3,3,6
"District Judge, 263rd Judicial District",0999,17,10,27,68,39.71%,23,3,26
"District Judge, 263rd Judicial District",1000,42,6,48,405,11.85%,13,34,47
"District Judge, 263rd Judicial District",1001,228,136,364,1565,23.26%,96,251,347
"District Judge, 263rd Judicial District",1002,170,139,309,1744,17.72%,54,237,291
"District Judge, 263rd Judicial District",1003,1,0,1,0,0.00%,1,0,1
"District Judge, 263rd Judicial District",1004,111,139,250,654,38.23%,127,106,233
"District Judge, 263rd Judicial District",1005,0,8,8,0,0.00%,3,3,6
"District Judge, 263rd Judicial District",1006,1,0,1,5,20.00%,1,0,1
"District Judge, 263rd Judicial District",1007,208,188,396,1547,25.60%,98,280,378
"District Judge, 263rd Judicial District",1008,32,12,44,151,29.14%,33,9,42
"District Judge, 263rd Judicial District",1009,0,0,0,9,0.00%,0,0,0
"District Judge, 263rd Judicial District",1010,59,35,94,459,20.48%,16,76,92
"District Judge, 263rd Judicial District",1011,8,1,9,26,34.62%,4,4,8
"District Judge, 263rd Judicial District",1012,134,201,335,1365,24.54%,102,224,326
"District Judge, 263rd Judicial District",1013,0,6,6,58,10.34%,3,3,6
"District Judge, 263rd Judicial District",1014,4,6,10,31,32.26%,1,9,10
"District Judge, 263rd Judicial District",1015,5,4,9,25,36.00%,3,5,8
"District Judge, 263rd Judicial District",1016,252,212,464,1691,27.44%,230,215,445
"District Judge, 263rd Judicial District",1017,61,44,105,330,31.82%,31,72,103
"District Judge, 263rd Judicial District",1018,93,64,157,494,31.78%,71,81,152
"District Judge, 263rd Judicial District",1019,130,107,237,1456,16.28%,11,224,235
"District Judge, 263rd Judicial District",1020,0,0,0,1,0.00%,0,0,0
"District Judge, 263rd Judicial District",1021,0,0,0,2,0.00%,0,0,0
"District Judge, 263rd Judicial District",1022,97,79,176,441,39.91%,132,34,166
"District Judge, 263rd Judicial District",1023,430,315,745,2026,36.77%,528,188,716
"District Judge, 263rd Judicial District",1024,55,61,116,249,46.59%,64,42,106
"District Judge, 263rd Judicial District",1025,0,1,1,14,7.14%,1,0,1
"District Judge, 263rd Judicial District",1026,0,0,0,0,0.00%,0,0,0
"District Judge, 263rd Judicial District",1027,1,0,1,8,12.50%,1,0,1
"District Judge, 263rd Judicial District",1028,0,0,0,0,0.00%,0,0,0
"District Judge, 263rd Judicial District",1029,537,719,1256,2927,42.91%,982,226,1208
"District Judge, 263rd Judicial District",1030,231,151,382,785,48.66%,329,45,374
"District Judge, 263rd Judicial District",1031,59,71,130,792,16.41%,33,88,121
"District Judge, 263rd Judicial District",1032,31,25,56,244,22.95%,34,18,52
"District Judge, 263rd Judicial District",1033,0,0,0,0,0.00%,0,0,0
"District Judge, 263rd Judicial District",1034,0,0,0,0,0.00%,0,0,0
"District Judge, 263rd Judicial District",1035,2,4,6,138,4.35%,1,5,6
"District Judge, 263rd Judicial District",1036,65,24,89,449,19.82%,74,14,88
"District Judge, 263rd Judicial District",1037,19,11,30,76,39.47%,16,11,27
"District Judge, 263rd Judicial District",1038,62,6,68,327,20.80%,9,56,65
"District Judge, 263rd Judicial District",1039,2,0,2,25,8.00%,0,2,2
"District Judge, 263rd Judicial District",1040,91,66,157,771,20.36%,73,79,152
"District Judge, 263rd Judicial District",1041,0,2,2,0,0.00%,1,1,2
"District Judge, 263rd Judicial District",1042,105,67,172,521,33.01%,51,113,164
"District Judge, 263rd Judicial District",1043,6,6,12,33,36.36%,4,8,12
"District Judge, 263rd Judicial District",1044,16,6,22,55,40.00%,7,14,21
"District Judge, 263rd Judicial District",1045,197,173,370,1788,20.69%,53,302,355
"District Judge, 263rd Judicial District",1046,11,5,16,62,25.81%,1,15,16
"District Judge, 263rd Judicial District",1047,255,186,441,1568,28.13%,164,265,429
"District Judge, 263rd Judicial District",1048,1,0,1,17,5.88%,1,0,1
"District Judge, 263rd Judicial District",1049,14,45,59,290,20.34%,20,37,57
"District Judge, 263rd Judicial District",1050,60,63,123,537,22.91%,35,84,119
"District Judge, 263rd Judicial District",1051,0,31,31,0,0.00%,19,10,29
"District Judge, 263rd Judicial District",1052,0,0,0,0,0.00%,0,0,0
"District Judge, 263rd Judicial District",1053,0,0,0,0,0.00%,0,0,0
"District Judge, 263rd Judicial District",1054,0,0,0,1,0.00%,0,0,0
"District Judge, 263rd Judicial District",1055,0,0,0,0,0.00%,0,0,0
"District Judge, 263rd Judicial District",1056,4,2,6,8,75.00%,0,5,5
"District Judge, 263rd Judicial District",1057,7,9,16,118,13.56%,3,12,15
"District Judge, 263rd Judicial District",1058,241,285,526,1243,42.32%,106,407,513
"District Judge, 263rd Judicial District",1059,3,3,6,28,21.43%,1,5,6
"District Judge, 263rd Judicial District",1060,5,2,7,42,16.67%,5,2,7
"District Judge, 263rd Judicial District",1061,332,184,516,1716,30.07%,277,218,495
"District Judge, 263rd Judicial District",1062,17,6,23,201,11.44%,4,16,20
"District Judge, 263rd Judicial District",1063,66,59,125,857,14.59%,19,103,122
"District Judge, 263rd Judicial District",1064,25,11,36,119,30.25%,28,8,36
"District Judge, 263rd Judicial District",1065,1,0,1,28,3.57%,0,1,1
"District Judge, 263rd Judicial District",1066,72,0,72,229,31.44%,3,66,69
"District Judge, 263rd Judicial District",1067,0,0,0,0,0.00%,0,0,0
"District Judge, 263rd Judicial District",1068,22,8,30,121,24.79%,14,15,29
"District Judge, 263rd Judicial District",1069,434,256,690,2580,26.74%,304,345,649
"District Judge, 263rd Judicial District",Totals:,378846,308736,687582,2044361,,355243,301380,656623
