Office,Precinct,Early Ballots Cast,Election Ballots Cast,Total Ballots Cast,Registered Voters,Percent Turnout,REP Roberta Lloyd,DEM Damon Crenshaw,Totals
"Judge, County Court at Law No. 4",0001,417,466,883,2358,37.45%,289,530,819
"Judge, County Court at Law No. 4",0002,333,313,646,1961,32.94%,265,334,599
"Judge, County Court at Law No. 4",0003,326,405,731,1560,46.86%,241,403,644
"Judge, County Court at Law No. 4",0004,359,487,856,1668,51.32%,278,501,779
"Judge, County Court at Law No. 4",0005,279,448,727,1417,51.31%,238,421,659
"Judge, County Court at Law No. 4",0006,656,456,1112,3702,30.04%,646,424,1070
"Judge, County Court at Law No. 4",0007,209,110,319,1017,31.37%,13,294,307
"Judge, County Court at Law No. 4",0008,393,310,703,1744,40.31%,355,316,671
"Judge, County Court at Law No. 4",0009,206,223,429,1874,22.89%,116,279,395
"Judge, County Court at Law No. 4",0010,255,171,426,1753,24.30%,129,265,394
"Judge, County Court at Law No. 4",0011,184,176,360,1785,20.17%,73,263,336
"Judge, County Court at Law No. 4",0012,86,66,152,735,20.68%,89,59,148
"Judge, County Court at Law No. 4",0013,548,361,909,2689,33.80%,652,214,866
"Judge, County Court at Law No. 4",0014,442,495,937,1870,50.11%,481,390,871
"Judge, County Court at Law No. 4",0015,597,898,1495,2878,51.95%,818,540,1358
"Judge, County Court at Law No. 4",0016,239,137,376,1071,35.11%,170,182,352
"Judge, County Court at Law No. 4",0017,185,215,400,1162,34.42%,175,196,371
"Judge, County Court at Law No. 4",0018,371,351,722,1443,50.03%,313,352,665
"Judge, County Court at Law No. 4",0019,170,207,377,1170,32.22%,116,235,351
"Judge, County Court at Law No. 4",0020,311,287,598,2646,22.60%,171,397,568
"Judge, County Court at Law No. 4",0021,175,184,360,1122,32.09%,73,268,341
"Judge, County Court at Law No. 4",0022,397,322,719,2473,29.07%,133,561,694
"Judge, County Court at Law No. 4",0023,31,22,53,541,9.80%,10,40,50
"Judge, County Court at Law No. 4",0024,106,88,194,655,29.62%,15,172,187
"Judge, County Court at Law No. 4",0025,104,143,247,1086,22.74%,13,228,241
"Judge, County Court at Law No. 4",0026,239,277,516,1845,27.97%,135,333,468
"Judge, County Court at Law No. 4",0027,463,427,890,3074,28.95%,223,614,837
"Judge, County Court at Law No. 4",0028,535,405,1041,3029,34.37%,668,319,987
"Judge, County Court at Law No. 4",0029,194,237,431,2638,16.34%,171,236,407
"Judge, County Court at Law No. 4",0030,368,391,759,2403,31.59%,195,525,720
"Judge, County Court at Law No. 4",0031,453,280,733,2511,29.19%,18,690,708
"Judge, County Court at Law No. 4",0032,318,405,723,2398,30.15%,285,383,668
"Judge, County Court at Law No. 4",0033,707,615,1322,3706,35.67%,409,822,1231
"Judge, County Court at Law No. 4",0034,625,579,1204,2786,43.22%,271,866,1137
"Judge, County Court at Law No. 4",0035,4,0,4,11,36.36%,1,3,4
"Judge, County Court at Law No. 4",0036,416,318,734,2927,25.08%,205,485,690
"Judge, County Court at Law No. 4",0037,542,436,978,2106,46.44%,282,622,904
"Judge, County Court at Law No. 4",0038,784,589,1373,2875,47.76%,434,838,1272
"Judge, County Court at Law No. 4",0039,657,575,1232,2759,44.65%,291,849,1140
"Judge, County Court at Law No. 4",0040,136,152,288,541,53.23%,121,145,266
"Judge, County Court at Law No. 4",0041,176,230,406,1334,30.43%,165,227,392
"Judge, County Court at Law No. 4",0042,228,109,337,1071,31.47%,5,320,325
"Judge, County Court at Law No. 4",0043,293,210,503,1695,29.68%,270,207,477
"Judge, County Court at Law No. 4",0044,204,222,426,2001,21.29%,97,299,396
"Judge, County Court at Law No. 4",0045,894,750,1644,6698,24.54%,322,1270,1592
"Judge, County Court at Law No. 4",0046,290,247,537,2511,21.39%,96,408,504
"Judge, County Court at Law No. 4",0047,213,218,431,1627,26.49%,18,403,421
"Judge, County Court at Law No. 4",0048,157,142,299,940,31.81%,24,265,289
"Judge, County Court at Law No. 4",0049,584,482,1066,3343,31.89%,774,260,1034
"Judge, County Court at Law No. 4",0050,785,771,1556,5211,29.86%,848,651,1499
"Judge, County Court at Law No. 4",0051,353,243,596,1689,35.29%,446,129,575
"Judge, County Court at Law No. 4",0052,422,447,869,2457,35.37%,395,416,811
"Judge, County Court at Law No. 4",0053,564,726,1290,2971,43.42%,491,700,1191
"Judge, County Court at Law No. 4",0054,269,364,633,1487,42.57%,318,267,585
"Judge, County Court at Law No. 4",0055,191,251,442,1506,29.35%,194,216,410
"Judge, County Court at Law No. 4",0056,282,278,560,1326,42.23%,364,163,527
"Judge, County Court at Law No. 4",0057,710,831,1541,3153,48.87%,560,845,1405
"Judge, County Court at Law No. 4",0058,469,556,1025,2690,38.10%,433,538,971
"Judge, County Court at Law No. 4",0059,555,609,1164,2544,45.75%,436,643,1079
"Judge, County Court at Law No. 4",0060,498,564,1062,2453,43.29%,247,736,983
"Judge, County Court at Law No. 4",0061,172,204,376,1773,21.21%,157,193,350
"Judge, County Court at Law No. 4",0062,145,322,467,2181,21.41%,121,320,441
"Judge, County Court at Law No. 4",0063,264,354,618,1826,33.84%,492,107,599
"Judge, County Court at Law No. 4",0064,191,221,412,2141,19.24%,88,302,390
"Judge, County Court at Law No. 4",0065,172,230,402,2167,18.55%,100,277,377
"Judge, County Court at Law No. 4",0066,69,143,212,1098,19.31%,37,161,198
"Judge, County Court at Law No. 4",0067,304,282,586,2794,20.97%,170,369,539
"Judge, County Court at Law No. 4",0068,553,352,905,2924,30.95%,21,863,884
"Judge, County Court at Law No. 4",0069,80,124,204,1284,15.89%,43,146,189
"Judge, County Court at Law No. 4",0070,882,664,1546,3337,46.33%,861,557,1418
"Judge, County Court at Law No. 4",0071,602,722,1324,4197,31.55%,639,609,1248
"Judge, County Court at Law No. 4",0072,220,293,513,1924,26.66%,169,319,488
"Judge, County Court at Law No. 4",0073,252,414,666,1555,42.83%,362,248,610
"Judge, County Court at Law No. 4",0074,1153,782,1935,3583,54.01%,1490,352,1842
"Judge, County Court at Law No. 4",0075,254,280,534,1444,36.98%,202,298,500
"Judge, County Court at Law No. 4",0076,373,374,747,2362,31.63%,436,276,712
"Judge, County Court at Law No. 4",0077,43,46,89,566,15.72%,20,65,85
"Judge, County Court at Law No. 4",0078,180,201,381,1522,25.03%,136,225,361
"Judge, County Court at Law No. 4",0079,205,306,511,2927,17.46%,136,334,470
"Judge, County Court at Law No. 4",0080,501,351,852,2725,31.27%,212,599,811
"Judge, County Court at Law No. 4",0081,183,187,370,1835,20.16%,141,206,347
"Judge, County Court at Law No. 4",0082,639,671,1310,3368,38.90%,977,289,1266
"Judge, County Court at Law No. 4",0083,1296,888,2184,6625,32.97%,1069,1025,2094
"Judge, County Court at Law No. 4",0084,208,218,426,1373,31.03%,313,95,408
"Judge, County Court at Law No. 4",0085,271,248,519,2173,23.88%,18,488,506
"Judge, County Court at Law No. 4",0086,447,568,1015,2910,34.88%,450,503,953
"Judge, County Court at Law No. 4",0087,574,787,1461,2818,51.85%,870,465,1335
"Judge, County Court at Law No. 4",0088,123,118,241,693,34.78%,153,74,227
"Judge, County Court at Law No. 4",0089,165,371,536,1094,48.99%,278,207,485
"Judge, County Court at Law No. 4",0090,844,790,1634,3700,44.16%,1174,382,1556
"Judge, County Court at Law No. 4",0091,219,222,441,1505,29.30%,265,158,423
"Judge, County Court at Law No. 4",0092,695,462,1157,2242,51.61%,757,323,1080
"Judge, County Court at Law No. 4",0093,381,301,682,3356,20.32%,274,363,637
"Judge, County Court at Law No. 4",0094,51,43,94,549,17.12%,28,62,90
"Judge, County Court at Law No. 4",0095,917,576,1493,3177,46.99%,1066,358,1424
"Judge, County Court at Law No. 4",0096,83,83,166,1296,12.81%,23,142,165
"Judge, County Court at Law No. 4",0097,1024,725,1749,4828,36.23%,1303,386,1689
"Judge, County Court at Law No. 4",0098,403,488,891,2651,33.61%,740,121,861
"Judge, County Court at Law No. 4",0099,254,184,438,2092,20.94%,213,209,422
"Judge, County Court at Law No. 4",0100,165,173,338,1730,19.54%,182,149,331
"Judge, County Court at Law No. 4",0101,72,58,130,946,13.74%,47,79,126
"Judge, County Court at Law No. 4",0102,207,121,328,1872,17.52%,90,224,314
"Judge, County Court at Law No. 4",0103,700,714,1414,5371,26.33%,801,569,1370
"Judge, County Court at Law No. 4",0104,530,231,761,1905,39.95%,17,726,743
"Judge, County Court at Law No. 4",0105,195,210,406,2165,18.75%,136,236,372
"Judge, County Court at Law No. 4",0106,18,7,25,294,8.50%,15,9,24
"Judge, County Court at Law No. 4",0107,154,197,351,2032,17.27%,58,276,334
"Judge, County Court at Law No. 4",0108,558,272,940,3365,27.93%,570,339,909
"Judge, County Court at Law No. 4",0109,529,245,774,2824,27.41%,11,745,756
"Judge, County Court at Law No. 4",0110,654,494,1148,3042,37.74%,744,366,1110
"Judge, County Court at Law No. 4",0111,816,795,1611,4102,39.27%,1177,357,1534
"Judge, County Court at Law No. 4",0112,542,485,1027,2976,34.51%,756,226,982
"Judge, County Court at Law No. 4",0113,562,429,991,2647,37.44%,598,343,941
"Judge, County Court at Law No. 4",0114,707,547,1254,3311,37.87%,1009,213,1222
"Judge, County Court at Law No. 4",0115,238,150,388,1800,21.56%,50,325,375
"Judge, County Court at Law No. 4",0116,982,776,1758,3147,55.86%,1309,332,1641
"Judge, County Court at Law No. 4",0117,215,226,441,1880,23.46%,218,197,415
"Judge, County Court at Law No. 4",0118,304,123,427,759,56.26%,349,62,411
"Judge, County Court at Law No. 4",0119,1288,1024,2312,5500,42.04%,1868,345,2213
"Judge, County Court at Law No. 4",0120,712,422,1134,3191,35.54%,739,343,1082
"Judge, County Court at Law No. 4",0121,92,178,270,848,31.84%,189,70,259
"Judge, County Court at Law No. 4",0122,352,225,577,1890,30.53%,24,529,553
"Judge, County Court at Law No. 4",0123,284,288,572,1392,41.09%,143,392,535
"Judge, County Court at Law No. 4",0124,1734,1292,3026,7254,41.71%,2386,555,2941
"Judge, County Court at Law No. 4",0125,415,332,747,2405,31.06%,457,261,718
"Judge, County Court at Law No. 4",0126,893,467,1360,3100,43.87%,1192,126,1318
"Judge, County Court at Law No. 4",0127,435,154,589,1836,32.08%,415,137,552
"Judge, County Court at Law No. 4",0128,445,707,1152,2290,50.31%,675,370,1045
"Judge, County Court at Law No. 4",0129,1030,1200,2230,5746,38.81%,1370,729,2099
"Judge, County Court at Law No. 4",0130,727,523,1250,2333,53.58%,910,275,1185
"Judge, County Court at Law No. 4",0131,251,259,510,1935,26.36%,122,361,483
"Judge, County Court at Law No. 4",0132,593,323,916,2387,38.37%,20,874,894
"Judge, County Court at Law No. 4",0133,513,858,1371,2662,51.50%,756,499,1255
"Judge, County Court at Law No. 4",0134,192,265,457,1437,31.80%,213,220,433
"Judge, County Court at Law No. 4",0135,727,579,1305,2671,48.90%,857,356,1213
"Judge, County Court at Law No. 4",0136,503,371,874,2013,43.42%,33,812,845
"Judge, County Court at Law No. 4",0137,166,141,307,716,42.88%,146,131,277
"Judge, County Court at Law No. 4",0138,296,199,495,1699,29.13%,16,469,485
"Judge, County Court at Law No. 4",0139,699,551,1250,3037,41.16%,520,644,1164
"Judge, County Court at Law No. 4",0140,699,480,1179,3214,36.68%,141,993,1134
"Judge, County Court at Law No. 4",0141,80,80,160,855,18.71%,97,54,151
"Judge, County Court at Law No. 4",0142,87,103,190,902,21.06%,65,116,181
"Judge, County Court at Law No. 4",0143,1962,580,2542,6386,39.81%,1833,644,2477
"Judge, County Court at Law No. 4",0144,216,158,374,1093,34.22%,11,354,365
"Judge, County Court at Law No. 4",0145,264,213,477,1538,31.01%,9,453,462
"Judge, County Court at Law No. 4",0146,426,519,945,2008,47.06%,403,487,890
"Judge, County Court at Law No. 4",0147,589,329,1018,3008,33.84%,133,860,993
"Judge, County Court at Law No. 4",0148,500,780,1280,2540,50.39%,460,700,1160
"Judge, County Court at Law No. 4",0149,1621,737,2358,7993,29.50%,1242,1056,2298
"Judge, County Court at Law No. 4",0150,236,169,405,1256,32.25%,12,388,400
"Judge, County Court at Law No. 4",0151,137,79,216,826,26.15%,11,197,208
"Judge, County Court at Law No. 4",0152,213,299,512,2788,18.36%,137,353,490
"Judge, County Court at Law No. 4",0153,125,206,331,1808,18.31%,113,203,316
"Judge, County Court at Law No. 4",0154,249,183,432,2190,19.73%,120,287,407
"Judge, County Court at Law No. 4",0155,1022,619,1641,4109,39.94%,1139,436,1575
"Judge, County Court at Law No. 4",0156,799,326,1125,3071,36.63%,40,1048,1088
"Judge, County Court at Law No. 4",0157,448,214,662,2236,29.61%,25,617,642
"Judge, County Court at Law No. 4",0158,600,315,915,3035,30.15%,25,869,894
"Judge, County Court at Law No. 4",0159,116,127,243,998,24.35%,39,196,235
"Judge, County Court at Law No. 4",0160,122,73,195,696,28.02%,7,185,192
"Judge, County Court at Law No. 4",0161,163,141,304,991,30.68%,4,290,294
"Judge, County Court at Law No. 4",0162,101,83,184,1265,14.55%,74,97,171
"Judge, County Court at Law No. 4",0163,230,320,550,3037,18.11%,236,285,521
"Judge, County Court at Law No. 4",0164,182,205,387,1420,27.25%,13,368,381
"Judge, County Court at Law No. 4",0165,535,483,1018,2334,43.62%,668,298,966
"Judge, County Court at Law No. 4",0166,158,233,391,1028,38.04%,118,250,368
"Judge, County Court at Law No. 4",0167,3,0,3,24,12.50%,0,3,3
"Judge, County Court at Law No. 4",0168,92,58,150,503,29.82%,3,143,146
"Judge, County Court at Law No. 4",0169,518,251,767,2513,30.52%,12,735,747
"Judge, County Court at Law No. 4",0170,271,141,412,1869,22.04%,217,172,389
"Judge, County Court at Law No. 4",0171,202,198,400,1604,24.94%,12,378,390
"Judge, County Court at Law No. 4",0172,88,80,166,621,26.73%,66,87,153
"Judge, County Court at Law No. 4",0173,817,739,1556,3599,43.23%,1247,256,1503
"Judge, County Court at Law No. 4",0174,829,733,1562,3296,47.39%,1062,409,1471
"Judge, County Court at Law No. 4",0175,557,749,1306,2618,49.89%,624,570,1194
"Judge, County Court at Law No. 4",0176,344,451,795,1602,49.63%,392,333,725
"Judge, County Court at Law No. 4",0177,278,326,604,1496,40.37%,324,235,559
"Judge, County Court at Law No. 4",0178,504,365,869,1765,49.24%,564,233,797
"Judge, County Court at Law No. 4",0179,256,188,444,1575,28.19%,237,181,418
"Judge, County Court at Law No. 4",0180,470,343,813,2834,28.69%,21,754,775
"Judge, County Court at Law No. 4",0181,175,262,437,2061,21.20%,140,273,413
"Judge, County Court at Law No. 4",0182,590,974,1564,3405,45.93%,905,514,1419
"Judge, County Court at Law No. 4",0183,519,794,1313,2491,52.71%,815,390,1205
"Judge, County Court at Law No. 4",0184,106,135,241,994,24.25%,86,132,218
"Judge, County Court at Law No. 4",0185,283,292,575,1933,29.75%,210,338,548
"Judge, County Court at Law No. 4",0186,97,106,203,798,25.44%,29,165,194
"Judge, County Court at Law No. 4",0187,21,25,46,311,14.79%,15,29,44
"Judge, County Court at Law No. 4",0188,153,146,299,1637,18.27%,140,145,285
"Judge, County Court at Law No. 4",0189,239,360,599,1465,40.89%,306,243,549
"Judge, County Court at Law No. 4",0190,120,177,297,1723,17.24%,130,155,285
"Judge, County Court at Law No. 4",0191,79,126,205,1366,15.01%,83,112,195
"Judge, County Court at Law No. 4",0192,380,225,605,1959,30.88%,25,560,585
"Judge, County Court at Law No. 4",0193,173,187,360,1074,33.52%,8,338,346
"Judge, County Court at Law No. 4",0194,350,431,781,1912,40.85%,232,504,736
"Judge, County Court at Law No. 4",0195,269,278,547,1694,32.29%,22,509,531
"Judge, County Court at Law No. 4",0196,52,32,84,316,26.58%,6,75,81
"Judge, County Court at Law No. 4",0197,543,309,852,2914,29.24%,14,821,835
"Judge, County Court at Law No. 4",0198,53,74,127,642,19.78%,2,123,125
"Judge, County Court at Law No. 4",0199,812,661,1473,3216,45.80%,1140,266,1406
"Judge, County Court at Law No. 4",0200,962,536,1498,3382,44.29%,651,731,1382
"Judge, County Court at Law No. 4",0201,98,87,185,724,25.55%,3,177,180
"Judge, County Court at Law No. 4",0202,217,189,406,1464,27.73%,10,386,396
"Judge, County Court at Law No. 4",0203,107,68,175,960,18.23%,42,123,165
"Judge, County Court at Law No. 4",0204,816,784,1600,3487,45.88%,870,606,1476
"Judge, County Court at Law No. 4",0205,464,171,635,1664,38.16%,10,615,625
"Judge, County Court at Law No. 4",0206,362,462,824,2779,29.65%,245,525,770
"Judge, County Court at Law No. 4",0207,265,261,526,1188,44.28%,165,324,489
"Judge, County Court at Law No. 4",0208,322,262,584,2195,26.61%,177,380,557
"Judge, County Court at Law No. 4",0209,0,2,2,0,0.00%,2,0,2
"Judge, County Court at Law No. 4",0210,502,467,969,2533,38.26%,107,829,936
"Judge, County Court at Law No. 4",0211,307,386,693,2914,23.78%,258,388,646
"Judge, County Court at Law No. 4",0212,96,155,251,1300,19.31%,56,187,243
"Judge, County Court at Law No. 4",0213,826,913,1739,3350,51.91%,1328,287,1615
"Judge, County Court at Law No. 4",0214,404,491,895,1854,48.27%,552,289,841
"Judge, County Court at Law No. 4",0215,421,711,1132,2258,50.13%,653,384,1037
"Judge, County Court at Law No. 4",0216,362,223,585,1945,30.08%,36,536,572
"Judge, County Court at Law No. 4",0217,844,631,1475,2678,55.08%,919,433,1352
"Judge, County Court at Law No. 4",0218,391,402,793,2292,34.60%,256,476,732
"Judge, County Court at Law No. 4",0219,496,436,932,2767,33.68%,45,846,891
"Judge, County Court at Law No. 4",0220,325,187,512,2310,22.16%,365,129,494
"Judge, County Court at Law No. 4",0221,332,369,701,2529,27.72%,301,360,661
"Judge, County Court at Law No. 4",0222,623,674,1297,2501,51.86%,548,624,1172
"Judge, County Court at Law No. 4",0223,563,377,940,3582,26.24%,260,620,880
"Judge, County Court at Law No. 4",0224,530,456,986,2238,44.06%,433,479,912
"Judge, County Court at Law No. 4",0225,376,405,781,3305,23.63%,388,355,743
"Judge, County Court at Law No. 4",0226,227,307,534,2436,21.92%,135,372,507
"Judge, County Court at Law No. 4",0227,558,423,981,1785,54.96%,684,200,884
"Judge, County Court at Law No. 4",0228,362,195,557,1050,53.05%,27,511,538
"Judge, County Court at Law No. 4",0229,31,96,127,815,15.58%,61,58,119
"Judge, County Court at Law No. 4",0230,185,116,301,1089,27.64%,7,284,291
"Judge, County Court at Law No. 4",0231,233,264,497,2232,22.27%,131,337,468
"Judge, County Court at Law No. 4",0232,361,474,835,1760,47.44%,442,330,772
"Judge, County Court at Law No. 4",0233,890,801,1691,4445,38.04%,780,763,1543
"Judge, County Court at Law No. 4",0234,1192,913,2105,3993,52.72%,1535,404,1939
"Judge, County Court at Law No. 4",0235,240,158,398,1356,29.35%,11,374,385
"Judge, County Court at Law No. 4",0236,354,235,589,2079,28.33%,22,551,573
"Judge, County Court at Law No. 4",0237,416,253,669,2161,30.96%,14,638,652
"Judge, County Court at Law No. 4",0238,339,245,584,1925,30.34%,14,554,568
"Judge, County Court at Law No. 4",0239,383,236,619,1964,31.52%,19,588,607
"Judge, County Court at Law No. 4",0240,585,243,828,2649,31.26%,20,788,808
"Judge, County Court at Law No. 4",0241,222,229,451,2372,19.01%,187,244,431
"Judge, County Court at Law No. 4",0242,173,162,335,1596,20.99%,197,120,317
"Judge, County Court at Law No. 4",0243,138,43,181,457,39.61%,0,180,180
"Judge, County Court at Law No. 4",0244,480,425,905,3117,29.03%,504,357,861
"Judge, County Court at Law No. 4",0245,945,799,1745,5828,29.94%,1230,473,1703
"Judge, County Court at Law No. 4",0246,584,513,1197,3315,36.11%,856,299,1155
"Judge, County Court at Law No. 4",0247,173,254,427,1582,26.99%,12,409,421
"Judge, County Court at Law No. 4",0248,161,167,328,2100,15.62%,99,215,314
"Judge, County Court at Law No. 4",0249,461,348,809,2719,29.75%,558,221,779
"Judge, County Court at Law No. 4",0250,109,164,273,964,28.32%,8,260,268
"Judge, County Court at Law No. 4",0251,278,436,714,2089,34.18%,28,671,699
"Judge, County Court at Law No. 4",0252,504,312,816,2377,34.33%,16,781,797
"Judge, County Court at Law No. 4",0253,379,222,601,2177,27.61%,11,576,587
"Judge, County Court at Law No. 4",0254,93,112,205,1550,13.23%,68,125,193
"Judge, County Court at Law No. 4",0255,525,648,1173,2482,47.26%,524,556,1080
"Judge, County Court at Law No. 4",0256,575,449,1024,3254,31.47%,495,473,968
"Judge, County Court at Law No. 4",0257,204,245,449,2523,17.80%,137,291,428
"Judge, County Court at Law No. 4",0258,839,800,1539,3322,49.34%,1173,347,1520
"Judge, County Court at Law No. 4",0259,555,382,1038,2361,43.96%,23,986,1009
"Judge, County Court at Law No. 4",0260,162,145,307,1260,24.37%,184,103,287
"Judge, County Court at Law No. 4",0261,124,120,244,1417,17.22%,102,131,233
"Judge, County Court at Law No. 4",0262,758,600,1358,4397,30.88%,835,439,1274
"Judge, County Court at Law No. 4",0263,858,712,1570,3693,42.51%,1201,307,1508
"Judge, County Court at Law No. 4",0264,480,457,937,2963,31.62%,567,306,873
"Judge, County Court at Law No. 4",0265,988,759,1747,3584,48.74%,1269,349,1618
"Judge, County Court at Law No. 4",0266,259,257,516,2104,24.52%,257,226,483
"Judge, County Court at Law No. 4",0267,146,166,312,1327,23.51%,161,129,290
"Judge, County Court at Law No. 4",0268,435,717,1152,2493,46.21%,640,384,1024
"Judge, County Court at Law No. 4",0269,702,453,1155,2030,56.90%,888,193,1081
"Judge, County Court at Law No. 4",0270,817,672,1489,3605,41.30%,827,573,1400
"Judge, County Court at Law No. 4",0271,656,382,1038,2518,41.22%,27,998,1025
"Judge, County Court at Law No. 4",0272,264,292,556,2162,25.72%,215,312,527
"Judge, County Court at Law No. 4",0273,548,689,1237,2470,50.08%,984,191,1175
"Judge, County Court at Law No. 4",0274,588,346,934,2153,43.38%,625,246,871
"Judge, County Court at Law No. 4",0275,207,236,443,1850,23.95%,105,322,427
"Judge, County Court at Law No. 4",0276,572,231,803,2536,31.66%,9,777,786
"Judge, County Court at Law No. 4",0277,170,186,356,1492,23.86%,171,168,339
"Judge, County Court at Law No. 4",0278,421,320,741,2454,30.20%,417,293,710
"Judge, County Court at Law No. 4",0279,250,223,473,1941,24.37%,282,170,452
"Judge, County Court at Law No. 4",0280,130,188,318,1524,20.87%,136,165,301
"Judge, County Court at Law No. 4",0281,655,742,1397,2633,53.06%,625,622,1247
"Judge, County Court at Law No. 4",0282,314,455,769,2042,37.66%,475,246,721
"Judge, County Court at Law No. 4",0283,0,0,0,0,0.00%,0,0,0
"Judge, County Court at Law No. 4",0284,574,336,910,3172,28.69%,420,445,865
"Judge, County Court at Law No. 4",0285,448,378,826,2540,32.52%,78,721,799
"Judge, County Court at Law No. 4",0286,1255,821,2076,6170,33.65%,196,1811,2007
"Judge, County Court at Law No. 4",0287,370,477,847,1621,52.25%,394,389,783
"Judge, County Court at Law No. 4",0288,532,313,845,2210,38.24%,16,812,828
"Judge, County Court at Law No. 4",0289,186,212,398,1564,25.45%,202,171,373
"Judge, County Court at Law No. 4",0290,245,298,543,1642,33.07%,407,117,524
"Judge, County Court at Law No. 4",0291,325,235,560,1225,45.71%,281,242,523
"Judge, County Court at Law No. 4",0292,207,147,354,1356,26.11%,44,300,344
"Judge, County Court at Law No. 4",0293,356,447,803,1759,45.65%,361,387,748
"Judge, County Court at Law No. 4",0294,488,221,709,2097,33.81%,9,687,696
"Judge, County Court at Law No. 4",0295,148,103,251,885,28.36%,6,241,247
"Judge, County Court at Law No. 4",0296,327,340,667,1713,38.94%,376,235,611
"Judge, County Court at Law No. 4",0297,280,249,529,2012,26.29%,230,266,496
"Judge, County Court at Law No. 4",0298,415,358,773,2121,36.45%,447,279,726
"Judge, County Court at Law No. 4",0299,178,117,295,1353,21.80%,116,155,271
"Judge, County Court at Law No. 4",0300,1389,1016,2405,5406,44.49%,1902,401,2303
"Judge, County Court at Law No. 4",0301,210,255,465,2352,19.77%,188,252,440
"Judge, County Court at Law No. 4",0302,353,343,696,2720,25.59%,408,262,670
"Judge, County Court at Law No. 4",0303,922,784,1706,3245,52.57%,1325,284,1609
"Judge, County Court at Law No. 4",0304,606,505,1111,2298,48.35%,606,420,1026
"Judge, County Court at Law No. 4",0305,524,432,956,4191,22.81%,405,520,925
"Judge, County Court at Law No. 4",0306,649,342,991,1879,52.74%,696,233,929
"Judge, County Court at Law No. 4",0307,733,670,1403,3099,45.27%,941,377,1318
"Judge, County Court at Law No. 4",0308,199,130,329,1296,25.39%,110,203,313
"Judge, County Court at Law No. 4",0309,708,593,1301,2524,51.55%,1013,207,1220
"Judge, County Court at Law No. 4",0310,386,279,665,1435,46.34%,437,179,616
"Judge, County Court at Law No. 4",0311,486,421,907,2986,30.38%,489,354,843
"Judge, County Court at Law No. 4",0312,742,457,1199,3636,32.98%,759,384,1143
"Judge, County Court at Law No. 4",0313,9,0,9,62,14.52%,7,1,8
"Judge, County Court at Law No. 4",0314,1121,913,2034,5647,36.02%,1269,695,1964
"Judge, County Court at Law No. 4",0315,478,388,866,1608,53.86%,493,309,802
"Judge, County Court at Law No. 4",0316,412,341,753,1537,48.99%,381,313,694
"Judge, County Court at Law No. 4",0317,248,209,457,1588,28.78%,145,288,433
"Judge, County Court at Law No. 4",0318,834,568,1402,3660,38.31%,71,1283,1354
"Judge, County Court at Law No. 4",0319,512,230,742,2158,34.38%,46,671,717
"Judge, County Court at Law No. 4",0320,234,168,402,1537,26.15%,209,174,383
"Judge, County Court at Law No. 4",0321,262,191,453,2346,19.31%,169,257,426
"Judge, County Court at Law No. 4",0322,181,129,310,1226,25.29%,100,199,299
"Judge, County Court at Law No. 4",0323,278,211,489,1722,28.40%,231,227,458
"Judge, County Court at Law No. 4",0324,532,646,1178,2336,50.43%,705,375,1080
"Judge, County Court at Law No. 4",0325,289,193,482,2112,22.82%,101,358,459
"Judge, County Court at Law No. 4",0326,87,74,161,698,23.07%,76,76,152
"Judge, County Court at Law No. 4",0327,380,129,509,1729,29.44%,10,482,492
"Judge, County Court at Law No. 4",0328,151,140,291,1434,20.29%,125,151,276
"Judge, County Court at Law No. 4",0329,189,184,373,1397,26.70%,148,205,353
"Judge, County Court at Law No. 4",0330,334,253,587,1936,30.32%,333,223,556
"Judge, County Court at Law No. 4",0331,0,0,0,0,0.00%,0,0,0
"Judge, County Court at Law No. 4",0332,18,7,25,138,18.12%,11,11,22
"Judge, County Court at Law No. 4",0333,524,714,1238,3021,40.98%,863,308,1171
"Judge, County Court at Law No. 4",0334,83,42,125,742,16.85%,21,100,121
"Judge, County Court at Law No. 4",0335,121,98,219,1300,16.85%,85,120,205
"Judge, County Court at Law No. 4",0336,866,624,1490,4051,36.78%,136,1321,1457
"Judge, County Court at Law No. 4",0337,124,103,227,1029,22.06%,42,174,216
"Judge, County Court at Law No. 4",0338,730,391,1121,4934,22.72%,389,652,1041
"Judge, County Court at Law No. 4",0339,202,222,424,1757,24.13%,91,305,396
"Judge, County Court at Law No. 4",0340,1038,594,1632,3765,43.35%,1220,332,1552
"Judge, County Court at Law No. 4",0341,91,167,258,1290,20.00%,83,166,249
"Judge, County Court at Law No. 4",0342,675,605,1280,6526,19.61%,215,1029,1244
"Judge, County Court at Law No. 4",0343,189,271,460,1964,23.42%,138,289,427
"Judge, County Court at Law No. 4",0344,154,172,326,1160,28.10%,14,297,311
"Judge, County Court at Law No. 4",0345,156,165,321,1804,17.79%,95,208,303
"Judge, County Court at Law No. 4",0346,0,1,1,3,33.33%,1,0,1
"Judge, County Court at Law No. 4",0347,592,436,1028,3387,30.35%,684,308,992
"Judge, County Court at Law No. 4",0348,438,208,646,1708,37.82%,498,118,616
"Judge, County Court at Law No. 4",0349,188,267,455,1349,33.73%,278,150,428
"Judge, County Court at Law No. 4",0350,524,526,1050,2909,36.09%,399,559,958
"Judge, County Court at Law No. 4",0351,1491,710,2201,4712,46.71%,1728,385,2113
"Judge, County Court at Law No. 4",0352,520,339,859,3205,26.80%,631,196,827
"Judge, County Court at Law No. 4",0353,665,451,1116,3862,28.90%,209,874,1083
"Judge, County Court at Law No. 4",0354,715,338,1053,3388,31.08%,268,753,1021
"Judge, County Court at Law No. 4",0355,301,264,565,1560,36.22%,49,500,549
"Judge, County Court at Law No. 4",0356,594,538,1132,2972,38.09%,726,351,1077
"Judge, County Court at Law No. 4",0357,837,575,1412,3517,40.15%,1032,329,1361
"Judge, County Court at Law No. 4",0358,212,254,466,2492,18.70%,54,397,451
"Judge, County Court at Law No. 4",0359,234,224,458,3061,14.96%,65,380,445
"Judge, County Court at Law No. 4",0360,522,380,902,2146,42.03%,449,370,819
"Judge, County Court at Law No. 4",0361,41,295,336,1673,20.08%,49,244,293
"Judge, County Court at Law No. 4",0362,1138,887,2025,5086,39.82%,1487,430,1917
"Judge, County Court at Law No. 4",0363,620,412,1032,3677,28.07%,471,527,998
"Judge, County Court at Law No. 4",0364,488,405,893,2658,33.60%,524,323,847
"Judge, County Court at Law No. 4",0365,478,231,709,1305,54.33%,53,639,692
"Judge, County Court at Law No. 4",0366,252,270,522,2454,21.27%,140,366,506
"Judge, County Court at Law No. 4",0367,170,138,308,1130,27.26%,71,230,301
"Judge, County Court at Law No. 4",0368,178,88,266,958,27.77%,74,181,255
"Judge, County Court at Law No. 4",0369,32,29,61,559,10.91%,17,42,59
"Judge, County Court at Law No. 4",0370,1532,1105,2637,6593,40.00%,2003,544,2547
"Judge, County Court at Law No. 4",0371,122,52,174,502,34.66%,7,161,168
"Judge, County Court at Law No. 4",0372,221,170,391,1224,31.94%,55,321,376
"Judge, County Court at Law No. 4",0373,21,12,33,157,21.02%,1,30,31
"Judge, County Court at Law No. 4",0374,85,93,158,738,21.41%,57,95,152
"Judge, County Court at Law No. 4",0375,254,220,474,2645,17.92%,239,200,439
"Judge, County Court at Law No. 4",0376,278,205,483,1910,25.29%,217,242,459
"Judge, County Court at Law No. 4",0377,525,583,1109,2920,37.98%,810,239,1049
"Judge, County Court at Law No. 4",0378,232,354,586,1829,32.04%,366,192,558
"Judge, County Court at Law No. 4",0379,431,289,720,2027,35.52%,72,626,698
"Judge, County Court at Law No. 4",0380,1299,995,2294,5666,40.49%,1255,961,2216
"Judge, County Court at Law No. 4",0381,412,248,660,2855,23.12%,310,321,631
"Judge, County Court at Law No. 4",0382,132,157,289,922,31.34%,216,64,280
"Judge, County Court at Law No. 4",0383,289,263,552,2173,25.40%,227,303,530
"Judge, County Court at Law No. 4",0384,573,373,946,2657,35.60%,184,725,909
"Judge, County Court at Law No. 4",0385,583,670,1253,2207,56.77%,922,248,1170
"Judge, County Court at Law No. 4",0386,662,469,1131,2922,38.71%,824,260,1084
"Judge, County Court at Law No. 4",0387,555,672,1227,3935,31.18%,891,292,1183
"Judge, County Court at Law No. 4",0388,1430,1010,2440,6888,35.42%,1420,941,2361
"Judge, County Court at Law No. 4",0389,91,208,299,1026,29.14%,45,229,274
"Judge, County Court at Law No. 4",0390,356,263,619,1480,41.82%,73,520,593
"Judge, County Court at Law No. 4",0391,508,260,768,1883,40.79%,480,248,728
"Judge, County Court at Law No. 4",0392,387,155,542,1446,37.48%,7,524,531
"Judge, County Court at Law No. 4",0393,165,185,350,1292,27.09%,163,174,337
"Judge, County Court at Law No. 4",0394,69,73,142,834,17.03%,69,67,136
"Judge, County Court at Law No. 4",0395,469,404,873,1846,47.29%,616,203,819
"Judge, County Court at Law No. 4",0396,622,216,838,2082,40.25%,17,804,821
"Judge, County Court at Law No. 4",0397,86,78,164,760,21,58%,79,80,159
"Judge, County Court at Law No. 4",0398,615,521,1136,4022,28.24%,614,490,1104
"Judge, County Court at Law No. 4",0399,402,366,768,2791,27.52%,417,325,742
"Judge, County Court at Law No. 4",0400,620,359,979,2411,40.61%,709,220,929
"Judge, County Court at Law No. 4",0401,330,205,535,1913,27.97%,25,494,519
"Judge, County Court at Law No. 4",0402,466,266,732,1794,40.80%,41,671,712
"Judge, County Court at Law No. 4",0403,475,498,973,1715,56.73%,507,366,873
"Judge, County Court at Law No. 4",0404,419,330,749,2585,28.97%,436,281,717
"Judge, County Court at Law No. 4",0405,0,0,0,0,0.00%,0,0,0
"Judge, County Court at Law No. 4",0406,137,67,204,628,32.48%,3,197,200
"Judge, County Court at Law No. 4",0407,688,793,1481,3769,39.29%,980,414,1394
"Judge, County Court at Law No. 4",0408,146,153,299,1691,17.68%,141,142,283
"Judge, County Court at Law No. 4",0409,122,149,271,1459,18.57%,112,149,261
"Judge, County Court at Law No. 4",0410,132,80,212,899,23.58%,44,157,201
"Judge, County Court at Law No. 4",0411,235,200,435,2339,18.60%,163,247,410
"Judge, County Court at Law No. 4",0412,74,44,118,468,25.21%,6,106,112
"Judge, County Court at Law No. 4",0413,767,386,1153,2992,38.54%,461,643,1104
"Judge, County Court at Law No. 4",0414,654,480,1134,3453,32.84%,869,217,1086
"Judge, County Court at Law No. 4",0415,539,598,1137,2203,51.61%,752,329,1081
"Judge, County Court at Law No. 4",0416,538,558,1096,3791,28.91%,606,447,1053
"Judge, County Court at Law No. 4",0417,353,385,738,2448,30.15%,375,327,702
"Judge, County Court at Law No. 4",0418,403,469,872,3584,24.33%,369,459,828
"Judge, County Court at Law No. 4",0419,571,324,895,2658,33.67%,595,260,855
"Judge, County Court at Law No. 4",0420,1036,874,1910,4762,40.11%,1555,272,1827
"Judge, County Court at Law No. 4",0421,36,37,73,410,17.80%,24,43,67
"Judge, County Court at Law No. 4",0422,731,402,1133,3345,33.87%,27,1086,1113
"Judge, County Court at Law No. 4",0423,108,120,228,1376,16.57%,74,142,216
"Judge, County Court at Law No. 4",0424,240,111,351,967,36.30%,209,124,333
"Judge, County Court at Law No. 4",0425,107,123,230,883,26.05%,86,134,220
"Judge, County Court at Law No. 4",0426,260,183,443,1218,36.37%,265,155,420
"Judge, County Court at Law No. 4",0427,179,134,313,1092,28.66%,139,152,291
"Judge, County Court at Law No. 4",0428,619,421,1040,4538,22.92%,338,621,959
"Judge, County Court at Law No. 4",0429,445,314,759,3197,23.74%,216,501,717
"Judge, County Court at Law No. 4",0430,161,133,294,1657,17.74%,86,191,277
"Judge, County Court at Law No. 4",0431,327,84,411,3417,12.03%,151,239,390
"Judge, County Court at Law No. 4",0432,123,157,280,1455,19.24%,110,158,268
"Judge, County Court at Law No. 4",0433,50,63,113,581,19.45%,27,81,108
"Judge, County Court at Law No. 4",0434,370,289,659,1503,43.85%,411,204,615
"Judge, County Court at Law No. 4",0435,855,636,1491,3252,45.85%,948,453,1401
"Judge, County Court at Law No. 4",0436,629,531,1160,2933,39.55%,716,370,1086
"Judge, County Court at Law No. 4",0437,521,512,1033,2033,50.81%,704,258,962
"Judge, County Court at Law No. 4",0438,517,389,1006,1861,54.06%,738,206,944
"Judge, County Court at Law No. 4",0439,710,884,1594,3554,44.85%,1120,374,1494
"Judge, County Court at Law No. 4",0440,664,858,1522,2930,51.95%,1176,245,1421
"Judge, County Court at Law No. 4",0441,345,420,765,1669,45.84%,574,147,721
"Judge, County Court at Law No. 4",0442,612,574,1186,2575,46.06%,970,169,1139
"Judge, County Court at Law No. 4",0443,225,138,354,646,56.35%,244,95,339
"Judge, County Court at Law No. 4",0444,587,583,1270,3262,38.93%,794,395,1189
"Judge, County Court at Law No. 4",0445,499,348,847,2026,41.81%,557,249,806
"Judge, County Court at Law No. 4",0446,31,22,53,291,18.21%,26,24,50
"Judge, County Court at Law No. 4",0447,93,86,179,637,28.10%,50,118,168
"Judge, County Court at Law No. 4",0448,590,778,1368,3138,43.59%,746,527,1273
"Judge, County Court at Law No. 4",0449,12,23,35,198,17.68%,3,32,35
"Judge, County Court at Law No. 4",0450,435,328,763,2635,28.96%,234,496,730
"Judge, County Court at Law No. 4",0451,1002,510,1512,2687,56.27%,1218,211,1429
"Judge, County Court at Law No. 4",0452,554,444,998,3048,32.74%,741,228,969
"Judge, County Court at Law No. 4",0453,231,262,493,1937,25.45%,197,272,469
"Judge, County Court at Law No. 4",0454,594,248,842,2561,32.88%,13,811,824
"Judge, County Court at Law No. 4",0455,367,165,532,1689,31.50%,20,505,525
"Judge, County Court at Law No. 4",0456,482,362,844,3513,24.03%,495,320,815
"Judge, County Court at Law No. 4",0457,0,0,0,0,0.00%,0,0,0
"Judge, County Court at Law No. 4",0458,471,237,708,1924,36.80%,35,650,685
"Judge, County Court at Law No. 4",0459,951,474,1425,3021,47.17%,1125,241,1366
"Judge, County Court at Law No. 4",0460,554,331,885,2837,31.19%,241,620,861
"Judge, County Court at Law No. 4",0461,1155,735,1900,3871,49.08%,1282,487,1769
"Judge, County Court at Law No. 4",0462,674,619,1293,3384,38.21%,471,755,1226
"Judge, County Court at Law No. 4",0463,480,404,884,3326,26.58%,406,447,853
"Judge, County Court at Law No. 4",0464,356,430,786,2257,34.82%,569,188,757
"Judge, County Court at Law No. 4",0465,687,520,1207,3564,33.87%,678,485,1163
"Judge, County Court at Law No. 4",0466,1058,614,1672,4184,39.96%,973,634,1607
"Judge, County Court at Law No. 4",0467,213,189,402,1270,31.65%,103,289,392
"Judge, County Court at Law No. 4",0468,352,443,795,3598,22.10%,262,499,761
"Judge, County Court at Law No. 4",0469,1294,547,1841,3985,46.20%,1440,304,1744
"Judge, County Court at Law No. 4",0470,185,176,361,1326,27.22%,265,75,340
"Judge, County Court at Law No. 4",0471,375,380,755,2387,31.63%,604,127,731
"Judge, County Court at Law No. 4",0472,198,278,476,1081,44.03%,174,258,432
"Judge, County Court at Law No. 4",0473,599,391,990,1806,54.82%,681,253,934
"Judge, County Court at Law No. 4",0474,559,588,1147,3037,37.77%,802,302,1104
"Judge, County Court at Law No. 4",0475,189,267,456,1809,25.21%,219,213,432
"Judge, County Court at Law No. 4",0476,404,473,877,2430,36.09%,505,337,842
"Judge, County Court at Law No. 4",0477,737,567,1304,3505,37.20%,1008,245,1253
"Judge, County Court at Law No. 4",0478,958,657,1615,4461,36.20%,1091,441,1532
"Judge, County Court at Law No. 4",0479,638,612,1250,2714,46.06%,918,275,1193
"Judge, County Court at Law No. 4",0480,493,450,943,2415,39.05%,678,222,900
"Judge, County Court at Law No. 4",0481,770,623,1393,3482,40.01%,1061,267,1328
"Judge, County Court at Law No. 4",0482,878,630,1508,4373,34.48%,1093,362,1455
"Judge, County Court at Law No. 4",0483,1042,478,1520,4308,35.28%,890,564,1454
"Judge, County Court at Law No. 4",0484,1107,930,2037,4979,40.91%,1461,498,1959
"Judge, County Court at Law No. 4",0485,1095,911,2006,5388,37.23%,1564,385,1949
"Judge, County Court at Law No. 4",0486,873,855,1728,3866,44.70%,1345,306,1651
"Judge, County Court at Law No. 4",0487,570,294,864,3860,22.38%,326,467,793
"Judge, County Court at Law No. 4",0488,268,254,522,1719,30.37%,200,283,483
"Judge, County Court at Law No. 4",0489,350,290,640,1893,33.81%,216,391,607
"Judge, County Court at Law No. 4",0490,444,368,812,1975,41.11%,290,486,776
"Judge, County Court at Law No. 4",0491,314,372,686,1888,36.33%,405,241,646
"Judge, County Court at Law No. 4",0492,556,410,966,2335,41.37%,580,332,912
"Judge, County Court at Law No. 4",0493,479,322,801,1853,43.23%,544,204,748
"Judge, County Court at Law No. 4",0494,381,247,628,2467,25.46%,83,529,612
"Judge, County Court at Law No. 4",0495,522,523,1045,2375,44.00%,750,227,977
"Judge, County Court at Law No. 4",0496,190,315,505,2160,23.38%,205,281,486
"Judge, County Court at Law No. 4",0497,526,243,769,2257,34.07%,23,723,746
"Judge, County Court at Law No. 4",0498,363,323,686,2297,29.87%,306,362,668
"Judge, County Court at Law No. 4",0499,750,518,1268,2326,54.51%,914,274,1188
"Judge, County Court at Law No. 4",0500,729,715,1444,3507,41.17%,995,387,1382
"Judge, County Court at Law No. 4",0501,341,417,758,1801,42.09%,272,424,696
"Judge, County Court at Law No. 4",0502,477,350,827,2501,33.07%,668,128,796
"Judge, County Court at Law No. 4",0503,174,116,290,1374,21.11%,116,155,271
"Judge, County Court at Law No. 4",0504,624,527,1151,2288,50.31%,739,345,1084
"Judge, County Court at Law No. 4",0505,531,562,1193,3773,31.62%,546,565,1111
"Judge, County Court at Law No. 4",0506,665,670,1335,3502,38.12%,242,1042,1284
"Judge, County Court at Law No. 4",0507,221,149,370,2452,15.09%,79,223,302
"Judge, County Court at Law No. 4",0508,492,412,904,3287,27.50%,360,475,835
"Judge, County Court at Law No. 4",0509,753,596,1349,3732,36.15%,952,326,1278
"Judge, County Court at Law No. 4",0510,687,514,1201,3590,33.45%,593,549,1142
"Judge, County Court at Law No. 4",0511,0,0,0,0,0.00%,0,0,0
"Judge, County Court at Law No. 4",0512,602,660,1262,5057,24.96%,621,609,1230
"Judge, County Court at Law No. 4",0513,1019,487,1506,2894,52.04%,1139,292,1431
"Judge, County Court at Law No. 4",0514,953,720,1673,4275,39.13%,1271,332,1603
"Judge, County Court at Law No. 4",0515,942,683,1625,3455,47.03%,1305,242,1547
"Judge, County Court at Law No. 4",0516,1000,800,1800,5356,33.61%,959,757,1716
"Judge, County Court at Law No. 4",0517,481,256,737,2954,24.95%,424,290,714
"Judge, County Court at Law No. 4",0518,635,693,1328,3943,33.68%,872,403,1275
"Judge, County Court at Law No. 4",0519,623,493,1116,2966,37.63%,831,244,1075
"Judge, County Court at Law No. 4",0520,473,457,930,4580,20.31%,178,731,909
"Judge, County Court at Law No. 4",0521,471,464,935,2866,32.62%,511,390,901
"Judge, County Court at Law No. 4",0522,715,572,1288,2689,47.90%,994,241,1235
"Judge, County Court at Law No. 4",0523,751,415,1166,3052,38.20%,788,327,1115
"Judge, County Court at Law No. 4",0524,567,459,1026,3410,30.09%,359,631,990
"Judge, County Court at Law No. 4",0525,707,482,1189,3091,38.47%,274,861,1135
"Judge, County Court at Law No. 4",0526,58,84,152,780,19.49%,43,99,142
"Judge, County Court at Law No. 4",0527,37,40,77,574,13.41%,39,36,75
"Judge, County Court at Law No. 4",0528,14,12,26,90,28.89%,2,22,24
"Judge, County Court at Law No. 4",0529,1043,491,1534,3710,41.35%,1316,158,1474
"Judge, County Court at Law No. 4",0530,114,107,221,1196,18.48%,53,152,205
"Judge, County Court at Law No. 4",0531,363,174,537,1145,46.90%,413,99,512
"Judge, County Court at Law No. 4",0532,205,146,351,1048,33.49%,254,85,339
"Judge, County Court at Law No. 4",0533,124,108,232,1119,20.73%,132,86,218
"Judge, County Court at Law No. 4",0534,783,524,1,307,3837,34.06%,993,253,1246
"Judge, County Court at Law No. 4",0535,33,29,62,416,14.90%,32,29,61
"Judge, County Court at Law No. 4",0536,554,780,1334,5139,25.96%,537,750,1287
"Judge, County Court at Law No. 4",0537,855,778,1633,3050,53.54%,1191,364,1555
"Judge, County Court at Law No. 4",0538,204,160,364,1303,27.94%,7,347,354
"Judge, County Court at Law No. 4",0539,15,241,256,64,400.00%,76,161,237
"Judge, County Court at Law No. 4",0540,378,316,694,1567,44.29%,262,376,638
"Judge, County Court at Law No. 4",0541,784,505,1289,4599,28.03%,188,1045,1233
"Judge, County Court at Law No. 4",0542,360,382,742,2557,29.02%,47,667,714
"Judge, County Court at Law No. 4",0543,141,213,354,1565,22.62%,125,208,333
"Judge, County Court at Law No. 4",0544,35,41,77,310,24.84%,12,64,76
"Judge, County Court at Law No. 4",0545,596,620,1216,3629,33.51%,617,552,1169
"Judge, County Court at Law No. 4",0546,2,2,4,37,10.81%,3,0,3
"Judge, County Court at Law No. 4",0547,501,466,967,2406,40.19%,688,238,926
"Judge, County Court at Law No. 4",0548,286,293,579,2215,26.14%,305,257,562
"Judge, County Court at Law No. 4",0549,343,418,761,2663,28.58%,110,634,744
"Judge, County Court at Law No. 4",0550,501,431,932,3031,30.75%,534,362,896
"Judge, County Court at Law No. 4",0551,1288,1394,2682,7034,38.13%,2026,575,2601
"Judge, County Court at Law No. 4",0552,847,883,1730,3415,50.66%,1429,245,1674
"Judge, County Court at Law No. 4",0553,578,529,1107,4686,23.62%,508,563,1071
"Judge, County Court at Law No. 4",0554,261,199,460,1757,26.18%,102,322,424
"Judge, County Court at Law No. 4",0555,225,277,502,2219,22.62%,108,371,479
"Judge, County Court at Law No. 4",0556,276,186,462,2319,19.92%,141,303,444
"Judge, County Court at Law No. 4",0557,455,183,638,2830,22.54%,270,288,558
"Judge, County Court at Law No. 4",0558,693,463,1156,4380,26.39%,421,688,1109
"Judge, County Court at Law No. 4",0559,540,494,1134,4969,22.82%,350,739,1089
"Judge, County Court at Law No. 4",0560,72,131,203,1120,18.13%,56,132,188
"Judge, County Court at Law No. 4",0561,362,436,798,3064,26.04%,475,286,761
"Judge, County Court at Law No. 4",0562,113,68,181,694,26.08%,28,149,177
"Judge, County Court at Law No. 4",0563,1107,376,1483,3105,47.76%,1158,257,1415
"Judge, County Court at Law No. 4",0564,470,426,896,3155,28.40%,238,613,851
"Judge, County Court at Law No. 4",0565,108,78,186,1354,13.74%,42,130,172
"Judge, County Court at Law No. 4",0566,417,324,741,2882,25.71%,242,476,718
"Judge, County Court at Law No. 4",0567,301,193,494,2238,22.07%,167,286,453
"Judge, County Court at Law No. 4",0568,876,685,1561,3594,43.43%,1012,455,1467
"Judge, County Court at Law No. 4",0569,572,667,1239,3525,35.15%,641,516,1157
"Judge, County Court at Law No. 4",0570,238,210,448,1562,28.68%,153,260,413
"Judge, County Court at Law No. 4",0571,155,149,304,1827,16.64%,123,169,292
"Judge, County Court at Law No. 4",0572,555,375,930,3108,29.92%,471,414,885
"Judge, County Court at Law No. 4",0573,290,151,441,1619,27.24%,5,431,436
"Judge, County Court at Law No. 4",0574,31,42,73,402,18.16%,10,63,73
"Judge, County Court at Law No. 4",0575,13,11,24,74,32.43%,18,5,23
"Judge, County Court at Law No. 4",0576,485,318,803,2734,29.37%,25,760,785
"Judge, County Court at Law No. 4",0577,147,88,235,608,38.65%,146,76,222
"Judge, County Court at Law No. 4",0578,409,538,947,1799,52.64%,572,321,893
"Judge, County Court at Law No. 4",0579,75,101,176,1056,16.67%,37,131,168
"Judge, County Court at Law No. 4",0580,179,118,297,1031,28.81%,4,282,286
"Judge, County Court at Law No. 4",0581,212,174,386,1032,37.40%,7,366,373
"Judge, County Court at Law No. 4",0582,258,171,429,1588,27.02%,22,395,417
"Judge, County Court at Law No. 4",0583,225,131,356,1262,28.21%,14,334,348
"Judge, County Court at Law No. 4",0584,182,93,275,1014,27.12%,11,258,269
"Judge, County Court at Law No. 4",0585,417,172,589,2511,23.46%,16,561,577
"Judge, County Court at Law No. 4",0586,638,680,1318,4316,30.54%,808,462,1270
"Judge, County Court at Law No. 4",0587,436,284,720,2598,27.71%,284,413,697
"Judge, County Court at Law No. 4",0588,758,674,1432,3645,39.29%,1025,350,1375
"Judge, County Court at Law No. 4",0589,500,386,886,3420,25.91%,502,355,857
"Judge, County Court at Law No. 4",0590,772,399,1171,2162,54.16%,907,220,1127
"Judge, County Court at Law No. 4",0591,183,231,414,2121,19.52%,126,270,396
"Judge, County Court at Law No. 4",0592,133,157,290,1350,21.48%,77,197,274
"Judge, County Court at Law No. 4",0593,543,564,1107,4380,25.27%,545,510,1055
"Judge, County Court at Law No. 4",0594,561,326,887,2490,35.62%,254,603,857
"Judge, County Court at Law No. 4",0595,201,178,379,1693,22.39%,70,301,371
"Judge, County Court at Law No. 4",0596,441,348,789,3007,26.24%,439,324,763
"Judge, County Court at Law No. 4",0597,367,394,761,3653,20.83%,343,405,748
"Judge, County Court at Law No. 4",0598,195,57,252,728,34.62%,203,42,245
"Judge, County Court at Law No. 4",0599,850,578,1428,4950,28.85%,511,867,1378
"Judge, County Court at Law No. 4",0600,667,429,1096,3957,27.70%,450,593,1043
"Judge, County Court at Law No. 4",0601,1073,756,1829,4057,45.08%,1386,380,1766
"Judge, County Court at Law No. 4",0602,293,235,528,1326,39.82%,390,124,514
"Judge, County Court at Law No. 4",0603,884,794,1678,4843,34.65%,1083,551,1634
"Judge, County Court at Law No. 4",0604,702,518,1220,3005,40.60%,1011,168,1179
"Judge, County Court at Law No. 4",0605,907,556,1463,5582,26.21%,369,1048,1417
"Judge, County Court at Law No. 4",0606,176,70,246,937,26.25%,3,238,241
"Judge, County Court at Law No. 4",0607,62,51,113,728,15.52%,13,94,107
"Judge, County Court at Law No. 4",0608,31,47,78,537,14.53%,47,27,74
"Judge, County Court at Law No. 4",0609,557,680,1347,3384,39.80%,833,437,1270
"Judge, County Court at Law No. 4",0610,231,188,419,1927,21.74%,214,172,386
"Judge, County Court at Law No. 4",0611,495,242,737,2488,29.62%,25,697,722
"Judge, County Court at Law No. 4",0612,996,497,1493,3307,45.15%,1122,287,1409
"Judge, County Court at Law No. 4",0613,186,204,390,1554,25.10%,63,316,379
"Judge, County Court at Law No. 4",0614,737,566,1303,4207,30.97%,506,747,1253
"Judge, County Court at Law No. 4",0615,480,299,779,1967,39.60%,494,261,755
"Judge, County Court at Law No. 4",0616,739,663,1402,3436,40.80%,986,361,1347
"Judge, County Court at Law No. 4",0617,541,393,934,3809,24.52%,390,521,911
"Judge, County Court at Law No. 4",0618,946,567,1513,6003,25.20%,779,683,1462
"Judge, County Court at Law No. 4",0619,1219,803,2022,4297,47.06%,1500,420,1920
"Judge, County Court at Law No. 4",0620,689,264,953,2897,32.90%,592,312,904
"Judge, County Court at Law No. 4",0621,154,101,255,1133,22.51%,133,109,242
"Judge, County Court at Law No. 4",0622,881,524,1405,4403,31.91%,871,482,1353
"Judge, County Court at Law No. 4",0623,887,487,1374,3691,37.23%,935,370,1305
"Judge, County Court at Law No. 4",0624,1,1,2,3,66.67%,1,1,2
"Judge, County Court at Law No. 4",0625,477,362,839,1820,46.10%,480,303,783
"Judge, County Court at Law No. 4",0626,581,440,1021,2861,35.69%,572,389,961
"Judge, County Court at Law No. 4",0627,346,322,668,3049,21.91%,249,388,637
"Judge, County Court at Law No. 4",0628,152,219,371,1675,22.15%,201,159,360
"Judge, County Court at Law No. 4",0629,37,53,90,696,12.93%,16,73,89
"Judge, County Court at Law No. 4",0630,974,600,1574,3905,40.31%,121,1406,1527
"Judge, County Court at Law No. 4",0631,822,404,1226,2846,43.08%,896,279,1175
"Judge, County Court at Law No. 4",0632,7,4,11,343,3.21%,3,7,10
"Judge, County Court at Law No. 4",0633,943,731,1674,3559,47.04%,1187,415,1602
"Judge, County Court at Law No. 4",0634,458,442,900,3029,29.71%,598,270,868
"Judge, County Court at Law No. 4",0635,743,485,1228,3393,36.19%,923,270,1193
"Judge, County Court at Law No. 4",0636,835,874,1710,4140,41.30%,1484,172,1656
"Judge, County Court at Law No. 4",0637,409,362,771,2512,30.69%,194,525,719
"Judge, County Court at Law No. 4",0638,304,245,549,2204,24.91%,45,482,527
"Judge, County Court at Law No. 4",0639,549,547,1096,2526,43.39%,877,171,1048
"Judge, County Court at Law No. 4",0640,641,459,1100,3733,29.47%,703,358,1061
"Judge, County Court at Law No. 4",0641,649,596,1245,3650,34.11%,832,365,1197
"Judge, County Court at Law No. 4",0642,471,394,865,1764,49.04%,694,125,819
"Judge, County Court at Law No. 4",0643,934,653,1587,5945,26.69%,629,907,1536
"Judge, County Court at Law No. 4",0644,1019,823,1842,5523,33.35%,1231,527,1758
"Judge, County Court at Law No. 4",0645,654,594,1248,4185,29.82%,669,521,1190
"Judge, County Court at Law No. 4",0646,364,287,651,2220,29.32%,211,400,611
"Judge, County Court at Law No. 4",0647,904,470,1374,6084,22.58%,409,857,1266
"Judge, County Court at Law No. 4",0648,838,579,1417,3367,42.08%,1019,349,1368
"Judge, County Court at Law No. 4",0649,687,434,1121,4576,24.50%,373,669,1042
"Judge, County Court at Law No. 4",0650,906,766,1672,3888,43.00%,1211,382,1593
"Judge, County Court at Law No. 4",0651,963,766,1729,5128,33.72%,1126,524,1650
"Judge, County Court at Law No. 4",0652,467,515,982,2815,34.88%,176,768,944
"Judge, County Court at Law No. 4",0653,0,4,4,0,0.00%,0,4,4
"Judge, County Court at Law No. 4",0654,950,1005,1955,6208,31.49%,1104,776,1880
"Judge, County Court at Law No. 4",0655,1115,1079,2195,6855,32.02%,1370,737,2107
"Judge, County Court at Law No. 4",0656,579,393,972,2674,36.35%,38,912,950
"Judge, County Court at Law No. 4",0657,246,172,418,1292,32.35%,169,230,399
"Judge, County Court at Law No. 4",0658,540,426,966,2807,34.41%,636,307,943
"Judge, County Court at Law No. 4",0659,1149,788,1937,4856,39.89%,1389,484,1873
"Judge, County Court at Law No. 4",0660,950,825,1775,5372,33.04%,166,1564,1730
"Judge, County Court at Law No. 4",0661,675,765,1440,4567,31.53%,848,537,1385
"Judge, County Court at Law No. 4",0662,1148,890,2038,4874,41.81%,1621,349,1970
"Judge, County Court at Law No. 4",0663,717,797,1514,3346,45.25%,744,661,1405
"Judge, County Court at Law No. 4",0664,352,250,602,2869,20.98%,144,430,574
"Judge, County Court at Law No. 4",0665,482,348,830,2154,38.53%,699,102,801
"Judge, County Court at Law No. 4",0666,0,0,0,0,0.00%,0,0,0
"Judge, County Court at Law No. 4",0667,488,502,990,2149,46.07%,773,176,949
"Judge, County Court at Law No. 4",0668,399,509,908,2775,32.72%,599,282,881
"Judge, County Court at Law No. 4",0669,850,738,1,588,3425,46.36%,1135,379,1514
"Judge, County Court at Law No. 4",0670,955,471,1427,2983,47.84%,1120,249,1369
"Judge, County Court at Law No. 4",0671,403,565,968,3037,31.87%,599,326,925
"Judge, County Court at Law No. 4",0672,959,862,1821,5706,31.91%,1238,523,1761
"Judge, County Court at Law No. 4",0673,729,516,1245,2995,41.57%,989,201,1190
"Judge, County Court at Law No. 4",0674,1071,618,1689,4091,41.29%,1265,357,1622
"Judge, County Court at Law No. 4",0675,0,1,1,0,0.00%,1,0,1
"Judge, County Court at Law No. 4",0676,0,0,0,0,0.00%,0,0,0
"Judge, County Court at Law No. 4",0677,127,127,254,1266,20.06%,93,145,238
"Judge, County Court at Law No. 4",0678,166,108,274,735,37.28%,178,75,253
"Judge, County Court at Law No. 4",0679,635,520,1155,3381,34.16%,873,234,1107
"Judge, County Court at Law No. 4",0680,21,14,35,162,21.60%,14,20,34
"Judge, County Court at Law No. 4",0681,1,0,1,5,20.00%,1,0,1
"Judge, County Court at Law No. 4",0682,711,654,1365,4216,32.38%,1019,297,1316
"Judge, County Court at Law No. 4",0683,29,20,49,276,17.75%,9,35,44
"Judge, County Court at Law No. 4",0684,27,22,49,223,21.97%,25,22,47
"Judge, County Court at Law No. 4",0685,110,29,139,307,45.28%,64,66,130
"Judge, County Court at Law No. 4",0686,17,12,29,208,13.94%,11,17,28
"Judge, County Court at Law No. 4",0687,549,537,1086,2609,41.63%,735,282,1017
"Judge, County Court at Law No. 4",0688,999,617,1616,3504,46.12%,1295,251,1546
"Judge, County Court at Law No. 4",0689,211,387,598,2346,25.49%,311,257,568
"Judge, County Court at Law No. 4",0690,926,1104,2030,5102,39.79%,1655,308,1963
"Judge, County Court at Law No. 4",0691,2,5,7,25,28.00%,3,4,7
"Judge, County Court at Law No. 4",0692,444,548,992,2847,34.84%,744,207,951
"Judge, County Court at Law No. 4",0693,167,91,258,666,38.74%,73,172,245
"Judge, County Court at Law No. 4",0694,260,120,380,845,44.97%,261,96,357
"Judge, County Court at Law No. 4",0695,232,193,425,1724,24.65%,272,139,411
"Judge, County Court at Law No. 4",0696,261,207,468,1982,23.61%,299,147,446
"Judge, County Court at Law No. 4",0697,605,613,1218,4413,27.60%,315,853,1168
"Judge, County Court at Law No. 4",0698,448,489,937,3189,29.38%,100,812,912
"Judge, County Court at Law No. 4",0699,568,414,982,2343,41.91%,642,274,916
"Judge, County Court at Law No. 4",0700,255,251,506,1371,36.91%,422,59,481
"Judge, County Court at Law No. 4",0701,56,43,99,588,16.84%,64,30,94
"Judge, County Court at Law No. 4",0702,64,70,134,539,24.86%,17,115,132
"Judge, County Court at Law No. 4",0703,372,490,862,1882,45.80%,619,203,822
"Judge, County Court at Law No. 4",0704,569,599,1168,3064,38.12%,946,168,1114
"Judge, County Court at Law No. 4",0705,114,113,227,1523,14.90%,31,188,219
"Judge, County Court at Law No. 4",0706,115,71,186,610,30.49%,93,82,175
"Judge, County Court at Law No. 4",0707,153,86,239,707,33.80%,153,71,224
"Judge, County Court at Law No. 4",0708,54,52,106,563,18.83%,51,47,98
"Judge, County Court at Law No. 4",0709,1375,947,2322,6848,33.91%,1425,831,2256
"Judge, County Court at Law No. 4",0710,371,462,833,2082,40.01%,442,323,765
"Judge, County Court at Law No. 4",0711,702,506,1208,3484,34.67%,726,409,1135
"Judge, County Court at Law No. 4",0712,491,463,954,3670,25.99%,415,519,934
"Judge, County Court at Law No. 4",0713,228,262,490,1907,25.69%,245,219,464
"Judge, County Court at Law No. 4",0714,36,19,55,296,18.58%,36,17,53
"Judge, County Court at Law No. 4",0715,176,187,363,1408,25.78%,207,136,343
"Judge, County Court at Law No. 4",0716,449,407,856,2680,31.94%,608,227,835
"Judge, County Court at Law No. 4",0717,373,250,623,2002,31.12%,75,532,607
"Judge, County Court at Law No. 4",0718,1017,806,1823,4229,43.11%,1266,449,1715
"Judge, County Court at Law No. 4",0719,247,137,384,1589,24.17%,232,134,366
"Judge, County Court at Law No. 4",0720,994,780,1774,4282,41.43%,1339,370,1709
"Judge, County Court at Law No. 4",0721,754,532,1286,2870,44.81%,832,383,1215
"Judge, County Court at Law No. 4",0722,871,494,1365,4479,30.48%,104,1217,1321
"Judge, County Court at Law No. 4",0723,401,202,603,1858,32.45%,129,450,579
"Judge, County Court at Law No. 4",0724,151,128,279,766,36.42%,207,59,266
"Judge, County Court at Law No. 4",0725,423,237,660,2237,29.50%,309,328,637
"Judge, County Court at Law No. 4",0726,592,402,994,2087,47.63%,875,93,968
"Judge, County Court at Law No. 4",0727,338,290,628,2488,25.24%,203,387,590
"Judge, County Court at Law No. 4",0728,209,151,360,880,40.91%,221,118,339
"Judge, County Court at Law No. 4",0729,136,59,195,464,42.03%,122,67,189
"Judge, County Court at Law No. 4",0730,428,359,787,1747,45.05%,507,233,740
"Judge, County Court at Law No. 4",0731,58,27,85,352,24.15%,26,57,83
"Judge, County Court at Law No. 4",0732,441,324,765,1924,39.76%,478,242,720
"Judge, County Court at Law No. 4",0733,13,7,20,215,9.30%,8,10,18
"Judge, County Court at Law No. 4",0734,1558,962,2520,7005,35.97%,1745,699,2444
"Judge, County Court at Law No. 4",0735,8,0,6,18,33.33%,6,0,6
"Judge, County Court at Law No. 4",0736,3,1,4,22,18.18%,0,3,3
"Judge, County Court at Law No. 4",0737,11,7,18,51,35.29%,13,5,18
"Judge, County Court at Law No. 4",0738,139,100,239,1361,17.56%,47,183,230
"Judge, County Court at Law No. 4",0739,353,301,654,2955,22.13%,341,285,626
"Judge, County Court at Law No. 4",0740,96,98,194,939,20.66%,130,56,186
"Judge, County Court at Law No. 4",0741,0,1,1,0,0.00%,0,0,0
"Judge, County Court at Law No. 4",0742,0,11,11,0,0.00%,6,5,11
"Judge, County Court at Law No. 4",0743,15,18,33,210,15.71%,19,12,31
"Judge, County Court at Law No. 4",0744,456,392,848,2027,41.84%,547,253,800
"Judge, County Court at Law No. 4",0745,683,372,1055,2494,42.30%,645,353,998
"Judge, County Court at Law No. 4",0746,114,77,191,691,27.64%,89,98,187
"Judge, County Court at Law No. 4",0747,550,467,1017,3743,27.17%,512,475,987
"Judge, County Court at Law No. 4",0748,170,140,310,1403,22.10%,166,134,300
"Judge, County Court at Law No. 4",0749,30,17,47,377,12.47%,8,37,45
"Judge, County Court at Law No. 4",0750,111,96,207,767,26.99%,126,77,203
"Judge, County Court at Law No. 4",0751,925,964,1889,5084,37.16%,1256,552,1808
"Judge, County Court at Law No. 4",0752,286,200,486,1483,32.77%,372,94,466
"Judge, County Court at Law No. 4",0753,55,73,128,259,49.42%,79,42,121
"Judge, County Court at Law No. 4",0754,0,0,0,0,0.00%,0,0,0
"Judge, County Court at Law No. 4",0755,442,584,1026,4294,23.89%,460,520,980
"Judge, County Court at Law No. 4",0756,251,177,428,1600,26.75%,173,236,409
"Judge, County Court at Law No. 4",0757,520,508,1028,4035,25.48%,190,799,989
"Judge, County Court at Law No. 4",0758,1114,692,1806,4096,44.09%,1453,292,1745
"Judge, County Court at Law No. 4",0759,465,413,878,2730,32.16%,565,277,842
"Judge, County Court at Law No. 4",0760,1432,639,2071,4367,47.42%,1707,272,1979
"Judge, County Court at Law No. 4",0761,548,253,801,1550,51.68%,548,199,747
"Judge, County Court at Law No. 4",0762,0,0,0,0,0.00%,0,0,0
"Judge, County Court at Law No. 4",0763,108,146,254,1212,20.96%,109,133,242
"Judge, County Court at Law No. 4",0764,1133,774,1907,5217,36.55%,1207,635,1842
"Judge, County Court at Law No. 4",0765,647,426,1073,4055,26.46%,449,568,1017
"Judge, County Court at Law No. 4",0766,40,25,65,392,16.58%,16,42,58
"Judge, County Court at Law No. 4",0767,10,2,12,86,13.95%,6,6,12
"Judge, County Court at Law No. 4",0768,1359,1015,2374,5857,40.53%,1947,360,2307
"Judge, County Court at Law No. 4",0769,54,16,70,183,38.25%,3,66,69
"Judge, County Court at Law No. 4",0770,31,25,56,323,17.34%,28,24,52
"Judge, County Court at Law No. 4",0771,324,254,578,2426,23.83%,342,216,558
"Judge, County Court at Law No. 4",0772,1792,851,2643,5709,46.30%,2015,505,2520
"Judge, County Court at Law No. 4",0773,473,312,785,2918,26.90%,228,496,724
"Judge, County Court at Law No. 4",0774,30,41,71,378,18.78%,15,54,69
"Judge, County Court at Law No. 4",0775,18,3,21,92,22.83%,0,21,21
"Judge, County Court at Law No. 4",0776,551,496,1047,3053,34.29%,617,383,1000
"Judge, County Court at Law No. 4",0777,46,40,86,652,13.19%,32,52,84
"Judge, County Court at Law No. 4",0778,0,0,0,0,0.00%,0,0,0
"Judge, County Court at Law No. 4",0779,64,51,115,940,12.23%,44,66,110
"Judge, County Court at Law No. 4",0780,63,59,122,595,20.50%,70,46,116
"Judge, County Court at Law No. 4",0781,666,273,939,3603,26.06%,445,400,845
"Judge, County Court at Law No. 4",0782,368,370,738,2236,33.01%,468,239,707
"Judge, County Court at Law No. 4",0783,49,13,62,294,21.09%,46,14,60
"Judge, County Court at Law No. 4",0784,208,128,336,1079,31.14%,7,313,320
"Judge, County Court at Law No. 4",0785,28,25,53,296,17.91%,28,25,53
"Judge, County Court at Law No. 4",0786,100,98,198,1251,15.83%,77,112,189
"Judge, County Court at Law No. 4",0787,46,52,98,488,20.08%,35,59,94
"Judge, County Court at Law No. 4",0788,74,32,106,454,23.35%,52,52,104
"Judge, County Court at Law No. 4",0789,0,3,3,3,100.00%,0,3,3
"Judge, County Court at Law No. 4",0790,0,0,0,3,0.00%,0,0,0
"Judge, County Court at Law No. 4",0791,0,0,0,0,0.00%,0,0,0
"Judge, County Court at Law No. 4",0792,269,239,508,1865,27.24%,121,363,484
"Judge, County Court at Law No. 4",0793,448,247,695,2484,27.98%,417,254,671
"Judge, County Court at Law No. 4",0794,124,144,268,2710,9.89%,38,223,261
"Judge, County Court at Law No. 4",0795,90,125,215,1217,17.67%,78,126,204
"Judge, County Court at Law No. 4",0796,83,51,134,476,28.15%,74,54,128
"Judge, County Court at Law No. 4",0797,0,0,0,0,0.00%,0,0,0
"Judge, County Court at Law No. 4",0798,99,111,210,500,42.00%,83,116,199
"Judge, County Court at Law No. 4",0799,28,15,43,161,26.71%,9,34,43
"Judge, County Court at Law No. 4",0800,588,642,1230,2932,41.95%,838,329,1167
"Judge, County Court at Law No. 4",0801,32,14,46,258,17.83%,16,27,43
"Judge, County Court at Law No. 4",0802,51,27,78,312,25.00%,14,62,76
"Judge, County Court at Law No. 4",0803,725,511,1236,2893,42.72%,907,283,1190
"Judge, County Court at Law No. 4",0804,932,591,1523,4768,31.94%,969,506,1475
"Judge, County Court at Law No. 4",0805,765,533,1298,2866,45.29%,1045,208,1253
"Judge, County Court at Law No. 4",0806,0,0,0,0,0.00%,0,0,0
"Judge, County Court at Law No. 4",0807,211,204,415,2028,20.46%,97,297,394
"Judge, County Court at Law No. 4",0808,12,17,29,131,22.14%,9,19,28
"Judge, County Court at Law No. 4",0809,7,6,13,92,14.13%,5,6,11
"Judge, County Court at Law No. 4",0810,9,16,25,211,11.85%,7,17,24
"Judge, County Court at Law No. 4",0811,29,50,79,270,29.26%,28,49,77
"Judge, County Court at Law No. 4",0812,0,0,0,0,0.00%,0,0,0
"Judge, County Court at Law No. 4",0813,938,761,1699,5807,29.26%,860,786,1646
"Judge, County Court at Law No. 4",0814,673,533,1206,5102,23.64%,312,856,1168
"Judge, County Court at Law No. 4",0815,0,0,0,0,0.00%,0,0,0
"Judge, County Court at Law No. 4",0816,10,0,10,73,13.70%,3,7,10
"Judge, County Court at Law No. 4",0817,0,0,0,0,0.00%,0,0,0
"Judge, County Court at Law No. 4",0818,86,39,125,616,20.29%,29,93,122
"Judge, County Court at Law No. 4",0819,64,30,94,240,39.17%,52,29,81
"Judge, County Court at Law No. 4",0820,0,0,0,0,0.00%,0,0,0
"Judge, County Court at Law No. 4",0821,124,120,244,1242,19.65%,37,199,236
"Judge, County Court at Law No. 4",0822,332,167,499,1535,32.51%,13,469,482
"Judge, County Court at Law No. 4",0823,821,564,1385,5087,27.23%,809,527,1336
"Judge, County Court at Law No. 4",0824,428,282,710,2700,26.30%,163,526,689
"Judge, County Court at Law No. 4",0825,0,0,0,0,0.00%,0,0,0
"Judge, County Court at Law No. 4",0826,73,50,123,358,34.36%,55,57,112
"Judge, County Court at Law No. 4",0827,60,98,158,979,16.14%,78,75,153
"Judge, County Court at Law No. 4",0828,541,388,929,1916,48.49%,731,150,881
"Judge, County Court at Law No. 4",0829,54,22,76,264,28.79%,18,57,75
"Judge, County Court at Law No. 4",0830,0,0,0,2,0.00%,0,0,0
"Judge, County Court at Law No. 4",0831,0,0,0,0,0.00%,0,0,0
"Judge, County Court at Law No. 4",0832,34,28,62,352,17.61%,16,43,59
"Judge, County Court at Law No. 4",0833,0,1,1,20,5.00%,0,1,1
"Judge, County Court at Law No. 4",0834,0,0,0,0,0.00%,0,0,0
"Judge, County Court at Law No. 4",0835,38,19,57,290,19.66%,14,39,53
"Judge, County Court at Law No. 4",0836,3,0,3,19,15.79%,1,2,3
"Judge, County Court at Law No. 4",0837,0,0,0,0,0.00%,0,0,0
"Judge, County Court at Law No. 4",0838,0,0,0,0,0.00%,0,0,0
"Judge, County Court at Law No. 4",0839,136,118,254,1128,22.52%,55,188,243
"Judge, County Court at Law No. 4",0840,381,174,555,1705,32.55%,194,348,542
"Judge, County Court at Law No. 4",0841,0,0,0,0,0.00%,0,0,0
"Judge, County Court at Law No. 4",0842,421,434,855,3259,26.24%,402,418,820
"Judge, County Court at Law No. 4",0843,0,1,1,0,0.00%,0,1,1
"Judge, County Court at Law No. 4",0844,1,0,1,11,9.09%,0,1,1
"Judge, County Court at Law No. 4",0845,54,9,63,134,47.01%,39,21,60
"Judge, County Court at Law No. 4",0846,23,24,47,229,20.52%,2,42,44
"Judge, County Court at Law No. 4",0847,305,211,516,2015,25.61%,142,358,500
"Judge, County Court at Law No. 4",0848,489,266,755,1856,40.68%,221,499,720
"Judge, County Court at Law No. 4",0849,201,291,492,2124,23.16%,196,276,472
"Judge, County Court at Law No. 4",0850,46,41,87,210,41.43%,31,54,85
"Judge, County Court at Law No. 4",0851,1029,657,1686,4709,35.80%,1147,469,1616
"Judge, County Court at Law No. 4",0852,0,0,0,1,0.00%,0,0,0
"Judge, County Court at Law No. 4",0853,575,620,1296,2882,44.97%,993,246,1239
"Judge, County Court at Law No. 4",0854,15,26,41,172,23.84%,6,33,39
"Judge, County Court at Law No. 4",0855,5,9,14,16,87.50%,5,8,13
"Judge, County Court at Law No. 4",0856,0,1,1,0,0.00%,0,1,1
"Judge, County Court at Law No. 4",0857,0,0,0,1,0.00%,0,0,0
"Judge, County Court at Law No. 4",0858,63,34,97,343,28.28%,3,90,93
"Judge, County Court at Law No. 4",0859,157,106,263,890,29.55%,71,185,256
"Judge, County Court at Law No. 4",0860,0,0,0,0,0.00%,0,0,0
"Judge, County Court at Law No. 4",0861,315,199,514,1842,27.90%,86,410,496
"Judge, County Court at Law No. 4",0862,0,0,0,0,0.00%,0,0,0
"Judge, County Court at Law No. 4",0863,101,54,155,584,26.54%,7,147,154
"Judge, County Court at Law No. 4",0864,193,299,492,2569,19.15%,144,324,468
"Judge, County Court at Law No. 4",0865,2,3,5,21,23.81%,0,5,5
"Judge, County Court at Law No. 4",0866,0,0,0,0,0.00%,0,0,0
"Judge, County Court at Law No. 4",0867,0,0,0,0,0.00%,0,0,0
"Judge, County Court at Law No. 4",0868,236,271,507,2326,21.80%,167,322,489
"Judge, County Court at Law No. 4",0869,53,39,92,470,19.57%,22,68,90
"Judge, County Court at Law No. 4",0870,0,0,0,0,0.00%,0,0,0
"Judge, County Court at Law No. 4",0871,1,0,1,3,33.33%,0,1,1
"Judge, County Court at Law No. 4",0872,5,3,8,59,13.56%,4,4,8
"Judge, County Court at Law No. 4",0873,98,75,173,737,23.4,7%,43,125,168
"Judge, County Court at Law No. 4",0874,763,707,1470,3223,45.61%,1090,315,1405
"Judge, County Court at Law No. 4",0875,904,527,1431,5147,27.80%,704,680,1384
"Judge, County Court at Law No. 4",0876,698,641,1339,3265,41.01%,1029,264,1293
"Judge, County Court at Law No. 4",0877,476,382,858,3032,28.30%,355,482,837
"Judge, County Court at Law No. 4",0878,427,354,781,1666,46.88%,643,113,756
"Judge, County Court at Law No. 4",0879,407,294,701,2667,26.28%,367,297,664
"Judge, County Court at Law No. 4",0880,543,447,990,2352,42.09%,793,161,954
"Judge, County Court at Law No. 4",0881,593,540,1133,4479,25.30%,399,704,1103
"Judge, County Court at Law No. 4",0882,426,291,717,2422,29.60%,437,254,691
"Judge, County Court at Law No. 4",0883,643,702,1345,5408,24.87%,248,1057,1305
"Judge, County Court at Law No. 4",0884,57,25,82,377,21.75%,9,70,79
"Judge, County Court at Law No. 4",0885,562,368,930,2619,35.51%,551,356,907
"Judge, County Court at Law No. 4",0886,128,108,236,675,34.96%,132,89,221
"Judge, County Court at Law No. 4",0887,50,67,117,418,27.99%,57,50,107
"Judge, County Court at Law No. 4",0888,0,3,3,0,0.00%,2,1,3
"Judge, County Court at Law No. 4",0889,14,0,14,57,24.56%,5,8,13
"Judge, County Court at Law No. 4",0890,164,103,267,1095,24.38%,81,163,244
"Judge, County Court at Law No. 4",0891,317,243,560,1331,42.07%,203,314,517
"Judge, County Court at Law No. 4",0892,115,86,201,808,24.88%,75,114,189
"Judge, County Court at Law No. 4",0893,0,2,2,6,33.33%,0,2,2
"Judge, County Court at Law No. 4",0894,0,3,3,0,0.00%,2,1,3
"Judge, County Court at Law No. 4",0895,156,286,442,793,55.74%,161,232,393
"Judge, County Court at Law No. 4",0896,370,297,667,1459,45.72%,233,381,614
"Judge, County Court at Law No. 4",0897,252,297,549,1701,32.28%,322,208,530
"Judge, County Court at Law No. 4",0898,0,0,0,3,0.00%,0,0,0
"Judge, County Court at Law No. 4",0899,2,0,2,8,25.00%,0,2,2
"Judge, County Court at Law No. 4",0900,0,2,2,10,20.00%,1,1,2
"Judge, County Court at Law No. 4",0901,0,0,0,0,0.00%,0,0,0
"Judge, County Court at Law No. 4",0902,394,486,880,2139,41.14%,469,351,820
"Judge, County Court at Law No. 4",0903,3,7,10,50,20.00%,2,6,8
"Judge, County Court at Law No. 4",0904,1,0,1,7,14.29%,1,0,1
"Judge, County Court at Law No. 4",0905,123,100,223,904,24.67%,99,111,210
"Judge, County Court at Law No. 4",0906,8,6,14,25,56.00%,7,6,13
"Judge, County Court at Law No. 4",0907,12,19,31,181,17.13%,6,25,31
"Judge, County Court at Law No. 4",0908,0,1,1,0,0.00%,0,1,1
"Judge, County Court at Law No. 4",0909,2,1,3,18,16.67%,0,3,3
"Judge, County Court at Law No. 4",0910,25,24,49,217,22.58%,19,27,46
"Judge, County Court at Law No. 4",0911,118,60,178,551,32.30%,121,50,171
"Judge, County Court at Law No. 4",0912,316,201,517,1273,40.61%,337,151,488
"Judge, County Court at Law No. 4",0913,0,0,0,0,0.00%,0,0,0
"Judge, County Court at Law No. 4",0914,169,179,348,701,49.64%,275,58,333
"Judge, County Court at Law No. 4",0915,0,0,0,0,0.00%,0,0,0
"Judge, County Court at Law No. 4",0916,417,240,657,1491,44.06%,528,109,637
"Judge, County Court at Law No. 4",0917,177,62,239,483,49.48%,154,68,222
"Judge, County Court at Law No. 4",0918,304,168,472,883,53.45%,354,93,447
"Judge, County Court at Law No. 4",0919,0,0,0,3,0.00%,0,0,0
"Judge, County Court at Law No. 4",0920,22,12,34,71,47.89%,23,10,33
"Judge, County Court at Law No. 4",0921,32,15,47,119,39.50%,33,13,46
"Judge, County Court at Law No. 4",0922,0,0,0,0,0.00%,0,0,0
"Judge, County Court at Law No. 4",0923,470,137,607,1511,40.17%,459,128,587
"Judge, County Court at Law No. 4",0924,0,0,0,0,0.00%,0,0,0
"Judge, County Court at Law No. 4",0925,0,0,0,0,0.00%,0,0,0
"Judge, County Court at Law No. 4",0926,171,128,299,796,37.56%,223,64,287
"Judge, County Court at Law No. 4",0927,44,30,74,270,27.41%,29,38,67
"Judge, County Court at Law No. 4",0928,3,0,3,8,37.50%,0,3,3
"Judge, County Court at Law No. 4",0929,0,0,0,0,0.00%,0,0,0
"Judge, County Court at Law No. 4",0930,109,54,163,584,27.91%,6,154,160
"Judge, County Court at Law No. 4",0931,30,40,70,130,53.85%,30,31,61
"Judge, County Court at Law No. 4",0932,0,0,0,0,0.00%,0,0,0
"Judge, County Court at Law No. 4",0933,115,85,200,627,31.90%,56,136,192
"Judge, County Court at Law No. 4",0934,2,0,2,63,3.17%,1,1,2
"Judge, County Court at Law No. 4",0935,3,2,5,54,9.26%,2,2,4
"Judge, County Court at Law No. 4",0936,s,2,10,81,12.35%,3,6,9
"Judge, County Court at Law No. 4",0937,0,0,0,0,0.00%,0,0,0
"Judge, County Court at Law No. 4",0938,30,14,44,231,19.05%,11,32,43
"Judge, County Court at Law No. 4",0939,0,0,0,2,0.00%,0,0,0
"Judge, County Court at Law No. 4",0940,0,0,0,10,0.00%,0,0,0
"Judge, County Court at Law No. 4",0941,9,10,19,25,76.00%,17,2,19
"Judge, County Court at Law No. 4",0942,53,27,80,156,51.28%,65,12,77
"Judge, County Court at Law No. 4",0943,164,80,244,547,44.61%,162,66,228
"Judge, County Court at Law No. 4",0944,20,4,24,45,53.33%,18,1,19
"Judge, County Court at Law No. 4",0945,1,2,3,17,17.65%,1,2,3
"Judge, County Court at Law No. 4",0946,0,1,1,13,7.69%,0,1,1
"Judge, County Court at Law No. 4",0947,177,246,423,799,52.94%,212,185,397
"Judge, County Court at Law No. 4",0948,0,14,14,1,1400.00%,8,3,11
"Judge, County Court at Law No. 4",0949,34,27,61,193,31.61%,34,27,61
"Judge, County Court at Law No. 4",0950,0,0,0,1,0.00%,0,0,0
"Judge, County Court at Law No. 4",0951,33,30,63,277,22.74%,17,45,62
"Judge, County Court at Law No. 4",0952,16,15,31,71,43.66%,16,13,29
"Judge, County Court at Law No. 4",0953,18,9,27,275,9.82%,4,22,26
"Judge, County Court at Law No. 4",0954,0,0,0,1,0.00%,0,0,0
"Judge, County Court at Law No. 4",0955,3,2,5,19,26.32%,4,1,5
"Judge, County Court at Law No. 4",0956,2,4,6,11,54.55%,2,4,6
"Judge, County Court at Law No. 4",0957,97,95,192,562,34.16%,23,166,189
"Judge, County Court at Law No. 4",0958,81,129,210,1081,19.43%,53,150,203
"Judge, County Court at Law No. 4",0959,0,0,0,0,0.00%,0,0,0
"Judge, County Court at Law No. 4",0960,196,157,353,976,36.17%,72,269,341
"Judge, County Court at Law No. 4",0961,15,0,16,56,28.57%,0,16,16
"Judge, County Court at Law No. 4",0962,10,17,27,88,30.68%,3,24,27
"Judge, County Court at Law No. 4",0963,54,41,105,426,24.65%,59,42,101
"Judge, County Court at Law No. 4",0964,568,437,1005,2372,42.37%,614,355,969
"Judge, County Court at Law No. 4",0965,31,21,52,343,15.16%,27,24,51
"Judge, County Court at Law No. 4",0966,129,83,212,1148,18.47%,76,131,207
"Judge, County Court at Law No. 4",0967,15,48,63,165,38.18%,19,43,62
"Judge, County Court at Law No. 4",0968,119,30,149,692,21.53%,30,117,147
"Judge, County Court at Law No. 4",0969,156,73,229,604,37.91%,0,226,226
"Judge, County Court at Law No. 4",0970,83,36,119,731,16.28%,17,99,116
"Judge, County Court at Law No. 4",0971,11,8,19,147,12.93%,1,16,17
"Judge, County Court at Law No. 4",09726,8,14,31,45.16%,13,0,13
"Judge, County Court at Law No. 4",0973,24,19,43,111,38.74%,20,19,39
"Judge, County Court at Law No. 4",0974,57,36,93,299,31.10%,59,31,90
"Judge, County Court at Law No. 4",0975,55,30,85,193,44.04%,38,40,78
"Judge, County Court at Law No. 4",0976,58,62,130,683,19.03%,86,41,127
"Judge, County Court at Law No. 4",0977,50,43,93,572,16.26%,42,50,92
"Judge, County Court at Law No. 4",0978,77,79,156,546,28.57%,29,123,152
"Judge, County Court at Law No. 4",0979,2,6,8,27,29.63%,4,3,7
"Judge, County Court at Law No. 4",0980,280,321,601,1389,43.27%,444,125,569
"Judge, County Court at Law No. 4",0981,0,0,0,0,0.00%,0,0,0
"Judge, County Court at Law No. 4",0982,312,312,624,1567,39.82%,508,90,598
"Judge, County Court at Law No. 4",0983,11,21,32,161,19.88%,19,12,31
"Judge, County Court at Law No. 4",0984,18,9,27,192,14.06%,4,22,26
"Judge, County Court at Law No. 4",0985,117,63,180,351,51.28%,97,72,169
"Judge, County Court at Law No. 4",0986,43,30,73,463,15.77%,12,60,72
"Judge, County Court at Law No. 4",0987,231,90,321,1155,27.79%,28,285,313
"Judge, County Court at Law No. 4",0988,24,12,36,123,29.27%,33,3,36
"Judge, County Court at Law No. 4",09896,6,12,43,27.91%,8,4,12
"Judge, County Court at Law No. 4",0990,16,1,17,140,12.14%,8,8,16
"Judge, County Court at Law No. 4",0991,0,0,0,1,0.00%,0,0,0
"Judge, County Court at Law No. 4",0992,157,107,264,1048,25.19%,146,106,252
"Judge, County Court at Law No. 4",0993,169,101,270,568,47.54%,219,42,261
"Judge, County Court at Law No. 4",0994,5,5,11,25,44.00%,2,9,11
"Judge, County Court at Law No. 4",0995,295,156,451,1393,32.38%,28,413,441
"Judge, County Court at Law No. 4",0996,135,140,275,694,39.63%,161,93,254
"Judge, County Court at Law No. 4",0997,101,163,264,1656,15.94%,60,200,260
"Judge, County Court at Law No. 4",0998,5,1,6,57,10.53%,3,3,6
"Judge, County Court at Law No. 4",0999,17,10,27,68,39.71%,23,3,26
"Judge, County Court at Law No. 4",1000,42,6,48,405,11.85%,12,35,47
"Judge, County Court at Law No. 4",1001,228,136,364,1565,23.26%,93,254,347
"Judge, County Court at Law No. 4",1002,170,139,309,1744,17.72%,55,238,293
"Judge, County Court at Law No. 4",1003,1,0,1,0,0.00%,1,0,1
"Judge, County Court at Law No. 4",1004,111,139,250,654,38.23%,121,104,225
"Judge, County Court at Law No. 4",1005,0,8,8,0,0.00%,3,4,7
"Judge, County Court at Law No. 4",1006,1,0,1,5,20.00%,1,0,1
"Judge, County Court at Law No. 4",1007,208,188,396,1547,25.60%,99,281,380
"Judge, County Court at Law No. 4",1008,32,12,44,151,29.14%,33,8,41
"Judge, County Court at Law No. 4",1009,0,0,0,9,0.00%,0,0,0
"Judge, County Court at Law No. 4",1010,59,35,94,459,20.48%,16,76,92
"Judge, County Court at Law No. 4",1011,8,1,9,26,34.62%,3,4,7
"Judge, County Court at Law No. 4",1012,134,201,335,1365,24.54%,103,222,325
"Judge, County Court at Law No. 4",1013,0,6,6,58,10.34%,4,2,6
"Judge, County Court at Law No. 4",1014,4,6,10,31,32.26%,1,9,10
"Judge, County Court at Law No. 4",1015,5,4,9,25,36.00%,3,5,8
"Judge, County Court at Law No. 4",1016,252,212,464,1691,27.44%,228,217,445
"Judge, County Court at Law No. 4",1017,61,44,105,330,31.82%,32,71,103
"Judge, County Court at Law No. 4",1018,93,64,157,494,31.78%,71,82,153
"Judge, County Court at Law No. 4",1019,130,107,237,1456,16.28%,11,222,233
"Judge, County Court at Law No. 4",1020,0,0,0,1,0.00%,0,0,0
"Judge, County Court at Law No. 4",1021,0,0,0,2,0.00%,0,0,0
"Judge, County Court at Law No. 4",1022,97,79,176,441,39.91%,132,33,165
"Judge, County Court at Law No. 4",1023,430,315,745,2026,36.77%,523,194,717
"Judge, County Court at Law No. 4",1024,55,61,116,249,46.59%,61,45,106
"Judge, County Court at Law No. 4",1025,0,1,1,14,7.14%,1,0,1
"Judge, County Court at Law No. 4",1026,0,0,0,0,0.00%,0,0,0
"Judge, County Court at Law No. 4",1027,1,0,1,8,12.50%,0,1,1
"Judge, County Court at Law No. 4",1028,0,0,0,0,0.00%,0,0,0
"Judge, County Court at Law No. 4",1029,537,719,1256,2927,42.91%,982,222,1204
"Judge, County Court at Law No. 4",1030,231,151,382,785,48.66%,330,45,375
"Judge, County Court at Law No. 4",1031,59,71,130,792,16.41%,36,87,123
"Judge, County Court at Law No. 4",1032,31,25,56,244,22.95%,35,17,52
"Judge, County Court at Law No. 4",1033,0,0,0,0,0.00%,0,0,0
"Judge, County Court at Law No. 4",1034,0,0,0,0,0.00%,0,0,0
"Judge, County Court at Law No. 4",1035,2,4,6,138,4.35%,1,4,5
"Judge, County Court at Law No. 4",1036,65,24,89,449,19.82%,73,14,87
"Judge, County Court at Law No. 4",1037,19,11,30,76,39.47%,17,11,28
"Judge, County Court at Law No. 4",1038,62,6,68,327,20.80%,9,55,64
"Judge, County Court at Law No. 4",1039,2,0,2,25,8.00%,0,2,2
"Judge, County Court at Law No. 4",1040,91,66,157,771,20.36%,72,79,151
"Judge, County Court at Law No. 4",1041,0,2,2,0,0.00%,1,1,2
"Judge, County Court at Law No. 4",1042,105,67,172,521,33.01%,52,112,164
"Judge, County Court at Law No. 4",1043,6,6,12,33,36.36%,3,9,12
"Judge, County Court at Law No. 4",1044,16,6,22,55,40.00%,7,14,21
"Judge, County Court at Law No. 4",1045,197,173,370,1788,20.69%,53,305,358
"Judge, County Court at Law No. 4",1046,11,5,16,62,25.81%,1,15,16
"Judge, County Court at Law No. 4",1047,255,186,441,1568,28.13%,163,266,429
"Judge, County Court at Law No. 4",1048,1,0,1,17,5.88%,1,0,1
"Judge, County Court at Law No. 4",1049,14,45,59,290,20.34%,21,36,57
"Judge, County Court at Law No. 4",1050,60,63,123,537,22.91%,34,85,119
"Judge, County Court at Law No. 4",1051,0,31,31,0,0.00%,17,12,29
"Judge, County Court at Law No. 4",1052,0,0,0,0,0.00%,0,0,0
"Judge, County Court at Law No. 4",1053,0,0,0,0,0.00%,0,0,0
"Judge, County Court at Law No. 4",1054,0,0,0,1,0.00%,0,0,0
"Judge, County Court at Law No. 4",1055,0,0,0,0,0.00%,0,0,0
"Judge, County Court at Law No. 4",1056,4,2,6,8,75.00%,1,5,6
"Judge, County Court at Law No. 4",1057,7,9,16,118,13.56%,3,12,15
"Judge, County Court at Law No. 4",1058,241,285,526,1243,42.32%,105,410,515
"Judge, County Court at Law No. 4",1059,3,3,6,28,21.43%,2,4,6
"Judge, County Court at Law No. 4",1060,5,2,7,42,16.67%,5,2,7
"Judge, County Court at Law No. 4",1061,332,184,516,1716,30.07%,277,218,495
"Judge, County Court at Law No. 4",1062,17,6,23,201,11.44%,4,16,20
"Judge, County Court at Law No. 4",1063,66,59,125,857,14.59%,20,101,121
"Judge, County Court at Law No. 4",1064,25,11,36,119,30.25%,29,7,36
"Judge, County Court at Law No. 4",1065,1,0,1,28,3.57%,0,1,1
"Judge, County Court at Law No. 4",1066,72,0,72,229,31.44%,3,65,68
"Judge, County Court at Law No. 4",1067,0,0,0,0,0.00%,0,0,0
"Judge, County Court at Law No. 4",1068,22,8,30,121,24.79%,12,17,29
"Judge, County Court at Law No. 4",1069,434,256,690,2580,26.74%,316,332,648
"Judge, County Court at Law No. 4",Totals:,378846,308736,687582,2044361,,354837,299989,654826
