Office,Precinct,Early Ballots Cast,Election Ballots Cast,Total Ballots Cast,Registered Voters,Percent Turnout,REP Phil Camus,Totals
"Constable, Precinct 5",0008,661,430,1091,1706,63.95%,640,640
"Constable, Precinct 5",0014,758,606,1364,1848,73.81%,879,879
"Constable, Precinct 5",0050,1901,1110,3011,4762,63.23%,1851,1851
"Constable, Precinct 5",0056,548,307,855,1285,66.54%,582,582
"Constable, Precinct 5",0095,1684,671,2355,3179,74.08%,1765,1765
"Constable, Precinct 5",0096,364,237,601,1241,48.43%,151,151
"Constable, Precinct 5",0116,1626,747,2373,3014,78.73%,1891,1891
"Constable, Precinct 5",0118,460,148,608,743,81.83%,509,509
"Constable, Precinct 5",0119,1924,1265,3189,4892,65.19%,2613,2613
"Constable, Precinct 5",0120,1197,632,1829,2986,61.25%,1246,1246
"Constable, Precinct 5",0121,193,244,437,679,64.36%,302,302
"Constable, Precinct 5",0129,2294,1449,3743,5495,68.12%,2600,2600
"Constable, Precinct 5",0130,1201,523,1724,2240,76.96%,1337,1337
"Constable, Precinct 5",0143,2993,660,3653,4598,79.45%,2784,2784
"Constable, Precinct 5",0146,759,614,1373,1953,70.30%,769,769
"Constable, Precinct 5",0149,2859,1322,4181,6103,68.51%,2279,2279
"Constable, Precinct 5",0155,1957,834,2791,4087,68.29%,2069,2069
"Constable, Precinct 5",0165,918,557,1475,2284,64.58%,1018,1018
"Constable, Precinct 5",0176,626,530,1156,1581,73.12%,724,724
"Constable, Precinct 5",0209,0,4,4,0,0.00%,4,4
"Constable, Precinct 5",0213,1603,939,2542,3308,76.84%,2049,2049
"Constable, Precinct 5",0234,2088,885,2973,3854,77.14%,2317,2317
"Constable, Precinct 5",0256,1059,766,1825,3226,56.57%,953,953
"Constable, Precinct 5",0258,1577,888,2465,3286,75.02%,1911,1911
"Constable, Precinct 5",0260,420,290,710,1187,59.81%,454,454
"Constable, Precinct 5",0262,1470,906,2376,4232,56.14%,1566,1566
"Constable, Precinct 5",0264,936,639,1575,2939,53.59%,979,979
"Constable, Precinct 5",0265,1936,674,2610,3617,72.16%,1984,1984
"Constable, Precinct 5",0269,1143,444,1587,1981,80.11%,1245,1245
"Constable, Precinct 5",0272,610,484,1094,2112,51.80%,545,545
"Constable, Precinct 5",0273,1139,634,1773,2426,73.08%,1445,1445
"Constable, Precinct 5",0274,1049,364,1413,2063,68.49%,998,998
"Constable, Precinct 5",0281,1087,903,1990,2610,76.25%,1268,1268
"Constable, Precinct 5",0282,690,591,1281,1988,64.44%,847,847
"Constable, Precinct 5",0283,0,0,0,0,0.00%,0,0
"Constable, Precinct 5",0284,1135,595,1730,3262,53.03%,849,849
"Constable, Precinct 5",0293,620,557,1177,1733,67.92%,660,660
"Constable, Precinct 5",0296,602,432,1034,1693,61.08%,676,676
"Constable, Precinct 5",0297,576,445,1021,1978,51.62%,483,483
"Constable, Precinct 5",0298,847,475,1322,2083,63.47%,844,844
"Constable, Precinct 5",0303,1772,755,2527,3172,79.67%,2021,2021
"Constable, Precinct 5",0304,970,648,1618,2266,71.40%,1071,1071
"Constable, Precinct 5",0305,1319,858,2177,3621,60.12%,1096,1096
"Constable, Precinct 5",0309,1385,612,1997,2529,78.96%,1657,1657
"Constable, Precinct 5",0310,617,348,965,1437,67.15%,700,700
"Constable, Precinct 5",0311,862,699,1561,2997,52.09%,832,832
"Constable, Precinct 5",0312,1600,718,2318,3669,63.18%,1464,1464
"Constable, Precinct 5",0314,2494,1221,3715,5225,71.10%,2561,2561
"Constable, Precinct 5",0315,711,479,1190,1618,73.55%,819,819
"Constable, Precinct 5",0316,682,411,1093,1522,71.81%,703,703
"Constable, Precinct 5",0317,551,336,887,1469,60.38%,392,392
"Constable, Precinct 5",0330,590,376,966,1849,52.24%,543,543
"Constable, Precinct 5",0335,285,246,531,1227,43.28%,228,228
"Constable, Precinct 5",0338,1540,824,2364,4673,50.59%,915,915
"Constable, Precinct 5",0356,1382,518,2000,2836,70.52%,1360,1360
"Constable, Precinct 5",0362,2131,1200,3331,4952,67.27%,2619,2619
"Constable, Precinct 5",0385,1099,621,1720,2175,79.08%,1362,1362
"Constable, Precinct 5",0395,830,491,1321,1820,72.58%,1058,1058
"Constable, Precinct 5",0398,1438,840,2278,3816,59.70%,1349,1349
"Constable, Precinct 5",0400,1048,506,1554,2238,69.44%,1206,1206
"Constable, Precinct 5",0403,791,527,1318,1703,77.39%,894,894
"Constable, Precinct 5",0407,1317,1000,2317,3652,63.44%,1659,1659
"Constable, Precinct 5",0421,124,92,216,467,46.25%,74,74
"Constable, Precinct 5",0424,435,1,57,592,888,66.67%,387,387
"Constable, Precinct 5",0425,227,234,461,875,52.69%,192,192
"Constable, Precinct 5",0426,415,283,698,1224,57.03%,450,450
"Constable, Precinct 5",0427,325,249,574,1115,51.48%,264,264
"Constable, Precinct 5",0428,1284,907,2191,4316,50.76%,873,873
"Constable, Precinct 5",0429,1091,777,1868,3929,47.54%,548,548
"Constable, Precinct 5",0430,403,335,738,1654,44.62%,247,247
"Constable, Precinct 5",0431,819,403,1222,3188,38.33%,477,477
"Constable, Precinct 5",0432,311,271,582,1344,43.30%,244,244
"Constable, Precinct 5",0433,139,106,245,573,42.76%,75,75
"Constable, Precinct 5",0435,1534,768,2302,3097,74.33%,1644,1644
"Constable, Precinct 5",0436,1334,709,2043,3012,67.83%,1356,1356
"Constable, Precinct 5",0437,951,542,1493,2007,74.39%,1132,1132
"Constable, Precinct 5",0438,1046,387,1433,1802,79.52%,1132,1132
"Constable, Precinct 5",0439,1526,905,2431,3416,71.17%,1875,1875
"Constable, Precinct 5",0440,1326,876,2202,2867,76.81%,1763,1763
"Constable, Precinct 5",0441,698,513,1211,1616,74.94%,949,949
"Constable, Precinct 5",0443,335,148,483,605,79.83%,368,368
"Constable, Precinct 5",0444,1258,731,1989,3172,62.70%,1341,1341
"Constable, Precinct 5",0445,830,443,1303,1938,67.23%,897,897
"Constable, Precinct 5",0453,559,475,1034,1885,54.85%,452,452
"Constable, Precinct 5",0461,1958,828,2786,3733,74.63%,2005,2005
"Constable, Precinct 5",0463,1124,656,1780,2962,60.09%,961,961
"Constable, Precinct 5",0483,1868,759,2627,4141,63.44%,1638,1638
"Constable, Precinct 5",0487,1005,612,1617,3318,48.73%,648,648
"Constable, Precinct 5",0488,580,440,1020,1713,59.54%,451,451
"Constable, Precinct 5",0490,876,439,1315,1944,67.64%,612,612
"Constable, Precinct 5",0491,667,489,1156,1782,64.87%,744,744
"Constable, Precinct 5",0492,1069,504,1573,2351,66.91%,980,980
"Constable, Precinct 5",0493,858,400,1258,1804,69.73%,932,932
"Constable, Precinct 5",0499,1301,517,1818,2304,78.91%,1429,1429
"Constable, Precinct 5",0503,359,273,632,1363,46.37%,254,254
"Constable, Precinct 5",0504,1129,538,1667,2197,75.88%,1276,1276
"Constable, Precinct 5",0507,582,385,967,2435,39.71%,249,249
"Constable, Precinct 5",0508,946,760,1706,3248,52.52%,754,754
"Constable, Precinct 5",0509,1340,864,2204,3536,62.33%,1687,1687
"Constable, Precinct 5",0510,1492,682,2174,3511,61.92%,1217,1217
"Constable, Precinct 5",0512,1558,1127,2685,4582,58.60%,1489,1489
"Constable, Precinct 5",0517,1208,653,1861,3320,56.05%,1147,1147
"Constable, Precinct 5",0521,1011,694,1705,2725,62.57%,1030,1030
"Constable, Precinct 5",0522,1171,658,1829,2682,68.20%,1478,1478
"Constable, Precinct 5",0523,1338,689,2027,3060,66.24%,1489,1489
"Constable, Precinct 5",0524,1237,675,1912,3292,58.08%,776,776
"Constable, Precinct 5",0539,26,209,235,71,330.99%,89,89
"Constable, Precinct 5",0546,4,4,8,30,26.67%,4,4
"Constable, Precinct 5",0547,877,647,1524,2408,63.29%,1146,1146
"Constable, Precinct 5",0553,1465,951,2416,4355,55.48%,1322,1322
"Constable, Precinct 5",0556,584,421,1005,2249,44.69%,366,366
"Constable, Precinct 5",0557,822,556,1378,2726,50.55%,568,568
"Constable, Precinct 5",0558,1588,824,2412,4084,59.06%,1075,1075
"Constable, Precinct 5",0559,1787,899,2686,4633,57.98%,1004,1004
"Constable, Precinct 5",0565,315,194,509,1373,37.07%,141,141
"Constable, Precinct 5",0566,1122,478,1600,2950,54.24%,631,631
"Constable, Precinct 5",0567,672,394,1066,2198,48.50%,371,371
"Constable, Precinct 5",0569,1294,865,2159,3249,66.45%,1358,1358
"Constable, Precinct 5",0572,1283,574,1857,2998,61.94%,1036,1036
"Constable, Precinct 5",0589,1033,738,1771,3130,56.58%,1106,1106
"Constable, Precinct 5",0600,1383,869,2252,3820,58.95%,1007,1007
"Constable, Precinct 5",0603,1437,1163,2600,3917,66.38%,1767,1767
"Constable, Precinct 5",0616,1352,970,2322,3378,68.74%,1760,1760
"Constable, Precinct 5",0617,1318,849,2167,3546,61.11%,1069,1069
"Constable, Precinct 5",0618,1920,1021,2941,5344,55.03%,1609,1609
"Constable, Precinct 5",0619,2133,857,2990,4266,70.09%,2401,2401
"Constable, Precinct 5",0620,2382,856,3238,5271,61.43%,1835,1835
"Constable, Precinct 5",0621,397,203,600,1173,51.15%,369,369
"Constable, Precinct 5",0622,1722,829,2551,4305,59.26%,1719,1719
"Constable, Precinct 5",0625,862,454,1316,1796,73.27%,905,905
"Constable, Precinct 5",0626,1148,655,1803,2838,63.53%,1073,1073
"Constable, Precinct 5",0627,795,647,1442,2964,48.65%,571,571
"Constable, Precinct 5",0639,828,711,1539,2501,61.54%,1248,1248
"Constable, Precinct 5",0642,871,447,1318,1779,74.09%,1117,1117
"Constable, Precinct 5",0643,2157,994,3151,5310,59.34%,1596,1596
"Constable, Precinct 5",0644,2123,1204,3327,5261,63.24%,2368,2368
"Constable, Precinct 5",0645,1639,895,2534,4035,62.80%,1471,1471
"Constable, Precinct 5",0646,708,456,1164,2163,53.81%,473,473
"Constable, Precinct 5",0647,1770,1020,2790,5593,49.88%,974,974
"Constable, Precinct 5",0649,1389,854,2243,4426,50.68%,894,894
"Constable, Precinct 5",0650,1328,939,2267,3151,71.95%,1822,1822
"Constable, Precinct 5",0651,2085,1070,3155,4931,63.98%,2201,2201
"Constable, Precinct 5",0667,989,547,1536,2181,70.43%,1238,1238
"Constable, Precinct 5",0678,297,164,461,756,60.98%,340,340
"Constable, Precinct 5",0684,72,24,96,187,51.34%,64,64
"Constable, Precinct 5",0685,167,29,196,326,60.12%,99,99
"Constable, Precinct 5",0686,46,34,80,196,40.82%,25,25
"Constable, Precinct 5",0689,505,651,1156,2276,50.79%,672,672
"Constable, Precinct 5",0706,222,135,357,529,67.49%,208,208
"Constable, Precinct 5",0709,2996,1297,4293,6239,68.81%,2908,2908
"Constable, Precinct 5",0711,1492,701,2193,3351,65.44%,1496,1496
"Constable, Precinct 5",0712,1200,858,2058,3348,61.47%,1089,1089
"Constable, Precinct 5",0720,1575,1044,2619,3903,67.10%,2056,2056
"Constable, Precinct 5",0727,931,466,1397,2488,56.15%,547,547
"Constable, Precinct 5",0730,800,437,1237,1630,75.89%,896,896
"Constable, Precinct 5",0731,121,36,157,373,42.09%,50,50
"Constable, Precinct 5",0751,1664,1254,2918,4451,65.56%,2144,2144
"Constable, Precinct 5",0761,917,219,1136,1464,77.60%,872,872
"Constable, Precinct 5",0765,1390,815,2205,3967,55.58%,1008,1008
"Constable, Precinct 5",0771,701,537,1238,2378,52.06%,751,751
"Constable, Precinct 5",0772,2927,1002,3929,5617,69.95%,3168,3168
"Constable, Precinct 5",0773,892,550,1442,2648,54.46%,494,494
"Constable, Precinct 5",0781,1152,555,1807,3716,48.63%,867,867
"Constable, Precinct 5",0788,156,58,214,481,44.49%,96,96
"Constable, Precinct 5",0800,1188,795,1983,2817,70.39%,1452,1452
"Constable, Precinct 5",0803,1305,630,1935,2718,71.19%,1518,1518
"Constable, Precinct 5",0804,1806,960,2766,4348,63.62%,1888,1888
"Constable, Precinct 5",0807,652,402,1054,2001,52.67%,326,326
"Constable, Precinct 5",0813,1967,1258,3225,5423,59.47%,1879,1879
"Constable, Precinct 5",0814,1772,955,2727,4503,60.56%,967,967
"Constable, Precinct 5",0826,153,89,242,342,70.76%,160,160
"Constable, Precinct 5",0829,107,56,163,266,61.28%,51,51
"Constable, Precinct 5",0835,87,53,140,292,47.95%,58,58
"Constable, Precinct 5",0836,8,3,11,19,57.89%,4,4
"Constable, Precinct 5",0839,353,240,593,1122,52.85%,199,199
"Constable, Precinct 5",0869,153,76,229,473,48.41%,58,58
"Constable, Precinct 5",0875,1719,927,2646,4031,65.64%,1550,1550
"Constable, Precinct 5",0877,1030,642,1672,2480,67.42%,926,926
"Constable, Precinct 5",0879,890,527,1417,2334,60.71%,826,826
"Constable, Precinct 5",0881,1510,877,2387,3619,65.96%,1114,1114
"Constable, Precinct 5",0882,940,457,1397,2328,60.01%,894,894
"Constable, Precinct 5",0917,280,137,417,481,86.69%,323,323
"Constable, Precinct 5",0918,489,135,624,883,70.67%,516,516
"Constable, Precinct 5",0919,0,3,3,3,100.00%,3,3
"Constable, Precinct 5",0920,6,0,6,13,46.15%,6,6
"Constable, Precinct 5",0921,71,9,80,87,91.95%,69,69
"Constable, Precinct 5",0923,663,87,750,826,90.80%,619,619
"Constable, Precinct 5",0938,73,14,87,256,33.98%,41,41
"Constable, Precinct 5",0939,1,0,1,1,100.00%,0,0
"Constable, Precinct 5",0941,13,9,22,25,88.00%,19,19
"Constable, Precinct 5",0942,as,24,92,159,57.86%,74,74
"Constable, Precinct 5",0943,296,63,359,536,66.98%,267,267
"Constable, Precinct 5",0944,30,6,36,39,92.31%,30,30
"Constable, Precinct 5",0951,79,44,123,218,56.42%,44,44
"Constable, Precinct 5",0952,24,16,40,70,57.14%,26,26
"Constable, Precinct 5",0955,5,20,25,18,138.89%,17,17
"Constable, Precinct 5",0971,27,21,48,129,37.21%,7,7
"Constable, Precinct 5",0972,10,7,17,29,58.62%,12,12
"Constable, Precinct 5",0981,0,0,0,0,0.00%,0,0
"Constable, Precinct 5",0984,43,49,92,198,46.46%,21,21
"Constable, Precinct 5",0985,172,67,239,336,71.13%,143,143
"Constable, Precinct 5",0986,129,86,215,404,53.22%,38,38
"Constable, Precinct 5",0990,37,15,52,154,33.77%,24,24
"Constable, Precinct 5",0991,0,0,0,1,0.00%,0,0
"Constable, Precinct 5",0992,309,202,511,1015,50.34%,326,326
"Constable, Precinct 5",0993,272,91,363,551,65.88%,298,298
"Constable, Precinct 5",1000,105,0,105,458,22.93%,33,33
"Constable, Precinct 5",1001,496,294,790,1566,50.45%,248,248
"Constable, Precinct 5",1002,464,314,778,1738,44.76%,182,182
"Constable, Precinct 5",1005,0,0,0,0,0.00%,0,0
"Constable, Precinct 5",1006,3,0,3,5,60.00%,3,3
"Constable, Precinct 5",1016,591,364,955,1626,58.73%,539,539
"Constable, Precinct 5",1023,894,401,1295,1964,65.94%,943,943
"Constable, Precinct 5",1054,0,0,0,1,0.00%,0,0
"Constable, Precinct 5",1061,665,300,965,1613,59.83%,625,625
"Constable, Precinct 5",1062,59,26,85,168,50.60%,32,32
"Constable, Precinct 5",1064,45,1,46,120,38.33%,37,37
"Constable, Precinct 5",Totals:,200491,112070,312561,497247,,195570,195570
