Office,Precinct,Early Ballots Cast,Election Ballots Cast,Total Ballots Cast,Registered Voters,Percent Turnout,REP Brett Busby,DEM Barbara Gardner,Totals
"Justice, 14th Court of Appeals District, Place 3",0001,808,516,1324,2155,61.44%,445,787,1232
"Justice, 14th Court of Appeals District, Place 3",0002,754,407,1161,1890,61.43%,538,546,1084
"Justice, 14th Court of Appeals District, Place 3",0003,660,474,1134,1519,74.65%,457,581,1038
"Justice, 14th Court of Appeals District, Place 3",0004,676,534,1210,1652,73.24%,464,667,1131
"Justice, 14th Court of Appeals District, Place 3",0005,472,518,990,1376,71.95%,373,529,902
"Justice, 14th Court of Appeals District, Place 3",0006,1251,929,2180,3616,60.29%,1164,914,2078
"Justice, 14th Court of Appeals District, Place 3",0007,495,124,619,1058,58.51%,13,592,605
"Justice, 14th Court of Appeals District, Place 3",0008,661,430,1091,1706,63.95%,523,502,1025
"Justice, 14th Court of Appeals District, Place 3",0009,473,382,855,1736,49.25%,175,620,795
"Justice, 14th Court of Appeals District, Place 3",0010,499,245,744,1722,43.21%,157,514,671
"Justice, 14th Court of Appeals District, Place 3",0011,418,335,753,1830,41.15%,130,569,699
"Justice, 14th Court of Appeals District, Place 3",0012,227,133,360,716,50.28%,186,159,345
"Justice, 14th Court of Appeals District, Place 3",0013,1140,443,1583,2823,56.08%,1031,467,1498
"Justice, 14th Court of Appeals District, Place 3",0014,761,606,1367,1848,73.97%,709,562,1271
"Justice, 14th Court of Appeals District, Place 3",0015,1144,1016,2160,2806,76.98%,1244,726,1970
"Justice, 14th Court of Appeals District, Place 3",0016,457,175,632,947,66.74%,289,289,578
"Justice, 14th Court of Appeals District, Place 3",0017,347,326,673,1105,60.90%,250,374,624
"Justice, 14th Court of Appeals District, Place 3",0018,550,483,1033,1396,74.00%,490,470,960
"Justice, 14th Court of Appeals District, Place 3",0019,423,261,684,995,68.74%,247,383,630
"Justice, 14th Court of Appeals District, Place 3",0020,679,470,1149,3074,37.38%,322,738,1060
"Justice, 14th Court of Appeals District, Place 3",0021,419,230,649,1013,64.07%,143,469,612
"Justice, 14th Court of Appeals District, Place 3",0022,888,554,1442,2524,57.13%,198,1183,1381
"Justice, 14th Court of Appeals District, Place 3",0023,100,65,165,512,32.23%,32,124,156
"Justice, 14th Court of Appeals District, Place 3",0024,225,121,346,611,56.63%,34,290,324
"Justice, 14th Court of Appeals District, Place 3",0025,244,304,548,1062,51.60%,19,507,526
"Justice, 14th Court of Appeals District, Place 3",0026,463,486,949,1843,51.49%,241,631,872
"Justice, 14th Court of Appeals District, Place 3",0027,821,595,1516,3005,50.45%,335,1070,1405
"Justice, 14th Court of Appeals District, Place 3",0028,1446,465,1911,2782,68.69%,1099,710,1809
"Justice, 14th Court of Appeals District, Place 3",0029,418,577,995,2659,37.42%,306,638,944
"Justice, 14th Court of Appeals District, Place 3",0030,798,588,1386,2034,68.14%,350,960,1310
"Justice, 14th Court of Appeals District, Place 3",0031,913,526,1439,2518,57.15%,25,1381,1406
"Justice, 14th Court of Appeals District, Place 3",0032,796,556,1352,2171,62.28%,645,592,1237
"Justice, 14th Court of Appeals District, Place 3",0033,1479,843,2322,3540,65.59%,924,1196,2120
"Justice, 14th Court of Appeals District, Place 3",0034,1013,749,1762,2676,65.84%,477,1181,1658
"Justice, 14th Court of Appeals District, Place 3",0035,4,0,4,12,33.33%,1,3,4
"Justice, 14th Court of Appeals District, Place 3",0036,993,479,1472,2868,51.32%,361,1023,1384
"Justice, 14th Court of Appeals District, Place 3",0037,801,479,1280,1885,67.90%,434,753,1187
"Justice, 14th Court of Appeals District, Place 3",0038,1241,673,1914,2703,70.81%,656,1102,1758
"Justice, 14th Court of Appeals District, Place 3",0039,1064,723,1787,2726,65.55%,508,1154,1662
"Justice, 14th Court of Appeals District, Place 3",0040,239,135,374,524,71.37%,189,151,340
"Justice, 14th Court of Appeals District, Place 3",0041,560,284,844,1197,70.51%,353,461,814
"Justice, 14th Court of Appeals District, Place 3",0042,505,139,644,1121,57.45%,10,608,618
"Justice, 14th Court of Appeals District, Place 3",0043,520,372,892,1644,54.26%,407,431,838
"Justice, 14th Court of Appeals District, Place 3",0044,492,314,806,1976,40.79%,159,586,745
"Justice, 14th Court of Appeals District, Place 3",0045,2434,1138,3572,6031,59.23%,583,2848,3431
"Justice, 14th Court of Appeals District, Place 3",0046,538,433,971,2468,39.34%,150,774,924
"Justice, 14th Court of Appeals District, Place 3",0047,535,345,880,1624,54.19%,24,842,866
"Justice, 14th Court of Appeals District, Place 3",0048,371,193,564,992,56.85%,45,496,541
"Justice, 14th Court of Appeals District, Place 3",0049,1229,669,1898,3144,60.37%,1293,517,1810
"Justice, 14th Court of Appeals District, Place 3",0050,1904,1110,3014,4762,63.29%,1510,1382,2892
"Justice, 14th Court of Appeals District, Place 3",0051,657,349,1006,1568,64.16%,702,257,959
"Justice, 14th Court of Appeals District, Place 3",0052,972,620,1592,2299,69.25%,800,662,1462
"Justice, 14th Court of Appeals District, Place 3",0053,1102,884,1986,2808,70.73%,838,973,1811
"Justice, 14th Court of Appeals District, Place 3",0054,607,402,1009,1408,71.66%,507,421,928
"Justice, 14th Court of Appeals District, Place 3",0055,441,394,835,1305,63.98%,334,430,764
"Justice, 14th Court of Appeals District, Place 3",0056,548,307,855,1285,66.54%,528,265,793
"Justice, 14th Court of Appeals District, Place 3",0057,1274,956,2230,3062,72.83%,947,1116,2063
"Justice, 14th Court of Appeals District, Place 3",0058,882,747,1629,2521,64.62%,691,822,1513
"Justice, 14th Court of Appeals District, Place 3",0059,914,751,1665,2283,72.93%,673,860,1533
"Justice, 14th Court of Appeals District, Place 3",0060,840,664,1504,2263,66.46%,417,970,1387
"Justice, 14th Court of Appeals District, Place 3",0061,435,528,963,2250,42.80%,238,673,911
"Justice, 14th Court of Appeals District, Place 3",0062,419,528,947,2190,43.24%,186,672,858
"Justice, 14th Court of Appeals District, Place 3",0063,674,400,1074,1784,60.20%,830,181,1011
"Justice, 14th Court of Appeals District, Place 3",0064,410,420,830,2090,39.71%,137,639,776
"Justice, 14th Court of Appeals District, Place 3",0065,404,532,936,2178,42.98%,160,721,881
"Justice, 14th Court of Appeals District, Place 3",0066,172,279,451,1090,41.38%,61,354,415
"Justice, 14th Court of Appeals District, Place 3",0067,665,574,1239,2742,45.19%,244,894,1138
"Justice, 14th Court of Appeals District, Place 3",0068,1199,486,1685,2782,60.57%,27,1599,1626
"Justice, 14th Court of Appeals District, Place 3",0069,218,284,502,1303,38.53%,75,369,444
"Justice, 14th Court of Appeals District, Place 3",0070,1634,726,2360,3142,75.11%,1395,789,2184
"Justice, 14th Court of Appeals District, Place 3",0071,1423,948,2371,3662,64.75%,1187,1018,2205
"Justice, 14th Court of Appeals District, Place 3",0072,441,562,1003,1882,53.29%,263,663,926
"Justice, 14th Court of Appeals District, Place 3",0073,500,496,996,1494,66.67%,536,376,912
"Justice, 14th Court of Appeals District, Place 3",0074,2212,530,2742,3632,75.50%,2053,513,2566
"Justice, 14th Court of Appeals District, Place 3",0075,482,370,852,1329,64.11%,331,460,791
"Justice, 14th Court of Appeals District, Place 3",0076,814,559,1383,2328,59.41%,709,584,1293
"Justice, 14th Court of Appeals District, Place 3",0077,168,81,249,565,44.07%,51,183,234
"Justice, 14th Court of Appeals District, Place 3",0078,359,344,703,1479,47.53%,192,436,628
"Justice, 14th Court of Appeals District, Place 3",0079,511,717,1228,2959,41.50%,209,916,1125
"Justice, 14th Court of Appeals District, Place 3",0080,1159,481,1640,2712,60.47%,335,1218,1553
"Justice, 14th Court of Appeals District, Place 3",0081,540,309,849,1839,46.17%,248,541,789
"Justice, 14th Court of Appeals District, Place 3",0082,1353,816,2169,3284,66.05%,1561,509,2070
"Justice, 14th Court of Appeals District, Place 3",0083,2528,1181,3809,5598,68.04%,1748,1912,3660
"Justice, 14th Court of Appeals District, Place 3",0084,444,346,790,1389,56.88%,544,216,760
"Justice, 14th Court of Appeals District, Place 3",0085,730,548,1278,2079,61.47%,25,1203,1228
"Justice, 14th Court of Appeals District, Place 3",0086,1054,689,1743,2637,66.10%,783,829,1612
"Justice, 14th Court of Appeals District, Place 3",0087,1222,861,2083,2749,75.77%,1277,626,1903
"Justice, 14th Court of Appeals District, Place 3",0088,235,162,397,678,58.55%,241,140,381
"Justice, 14th Court of Appeals District, Place 3",0089,343,454,797,1104,72.19%,443,285,728
"Justice, 14th Court of Appeals District, Place 3",0090,1498,958,2456,3571,68.78%,1733,589,2322
"Justice, 14th Court of Appeals District, Place 3",0091,466,333,799,1248,64.02%,473,294,767
"Justice, 14th Court of Appeals District, Place 3",0092,1105,534,1639,2228,73.56%,1059,469,1528
"Justice, 14th Court of Appeals District, Place 3",0093,782,643,1425,3295,43.25%,485,847,1332
"Justice, 14th Court of Appeals District, Place 3",0094,148,104,252,537,46.93%,49,189,238
"Justice, 14th Court of Appeals District, Place 3",0095,1585,571,2356,3179,74.11%,1550,662,2212
"Justice, 14th Court of Appeals District, Place 3",0096,364,237,601,1241,48.43%,54,528,582
"Justice, 14th Court of Appeals District, Place 3",0097,2393,764,3157,4566,69.14%,2233,765,2998
"Justice, 14th Court of Appeals District, Place 3",0098,874,607,1481,2403,61.63%,1182,239,1421
"Justice, 14th Court of Appeals District, Place 3",0099,568,311,879,2040,43.09%,385,459,844
"Justice, 14th Court of Appeals District, Place 3",0100,427,324,751,1754,42.82%,325,395,720
"Justice, 14th Court of Appeals District, Place 3",0101,204,186,390,941,41.45%,85,294,379
"Justice, 14th Court of Appeals District, Place 3",0102,493,268,761,1910,39.84%,187,548,735
"Justice, 14th Court of Appeals District, Place 3",0103,1915,1065,2980,4751,62.72%,1520,1328,2848
"Justice, 14th Court of Appeals District, Place 3",0104,992,238,1230,1847,66.59%,23,1172,1195
"Justice, 14th Court of Appeals District, Place 3",0105,462,453,915,2153,42.50%,219,628,847
"Justice, 14th Court of Appeals District, Place 3",0106,49,37,86,284,30.28%,40,42,82
"Justice, 14th Court of Appeals District, Place 3",0107,412,441,853,1905,44.78%,127,689,816
"Justice, 14th Court of Appeals District, Place 3",0108,1194,514,1708,3229,52.90%,863,759,1622
"Justice, 14th Court of Appeals District, Place 3",0109,1160,430,1590,2884,55.13%,24,1523,1547
"Justice, 14th Court of Appeals District, Place 3",0110,1465,589,2054,2853,71.99%,1193,756,1949
"Justice, 14th Court of Appeals District, Place 3",0111,1868,848,2716,3638,74.66%,1966,592,2558
"Justice, 14th Court of Appeals District, Place 3",0112,1262,668,1930,2894,66.69%,1310,535,1845
"Justice, 14th Court of Appeals District, Place 3",0113,1125,590,1715,2537,67.60%,935,687,1622
"Justice, 14th Court of Appeals District, Place 3",0114,1454,546,2000,2650,75.47%,1522,397,1919
"Justice, 14th Court of Appeals District, Place 3",0115,598,305,903,1764,51.19%,97,781,878
"Justice, 14th Court of Appeals District, Place 3",0116,1626,747,2373,3014,78.73%,1749,486,2235
"Justice, 14th Court of Appeals District, Place 3",0117,398,462,860,1878,45.79%,330,483,813
"Justice, 14th Court of Appeals District, Place 3",0118,460,148,608,743,81.83%,471,104,575
"Justice, 14th Court of Appeals District, Place 3",0119,1924,1265,3189,4892,65.19%,2462,617,3079
"Justice, 14th Court of Appeals District, Place 3",0120,1198,632,1830,2986,61.29%,1067,643,1710
"Justice, 14th Court of Appeals District, Place 3",0121,193,244,437,679,64.36%,281,133,414
"Justice, 14th Court of Appeals District, Place 3",0122,895,349,1244,2199,56.57%,33,1161,1194
"Justice, 14th Court of Appeals District, Place 3",0123,440,350,790,1356,58.26%,220,519,739
"Justice, 14th Court of Appeals District, Place 3",0124,3522,1281,4803,5952,80.70%,3713,870,4583
"Justice, 14th Court of Appeals District, Place 3",0125,896,534,1430,2281,62.69%,795,570,1365
"Justice, 14th Court of Appeals District, Place 3",0126,1630,407,2037,2799,72.78%,1709,234,1943
"Justice, 14th Court of Appeals District, Place 3",0127,854,182,1036,1703,60.83%,710,286,996
"Justice, 14th Court of Appeals District, Place 3",0128,936,736,1672,2257,74.08%,1026,487,1513
"Justice, 14th Court of Appeals District, Place 3",0129,2294,1449,3743,5495,68.12%,2230,1280,3510
"Justice, 14th Court of Appeals District, Place 3",0130,1203,523,1726,2240,77.05%,1228,386,1614
"Justice, 14th Court of Appeals District, Place 3",0131,604,374,978,1721,56.83%,223,715,938
"Justice, 14th Court of Appeals District, Place 3",0132,1119,397,1516,2449,61.90%,24,1443,1467
"Justice, 14th Court of Appeals District, Place 3",0133,1088,940,2028,2605,77.85%,1202,650,1852
"Justice, 14th Court of Appeals District, Place 3",0134,420,392,812,1444,56.23%,344,419,763
"Justice, 14th Court of Appeals District, Place 3",0135,1425,634,2059,2750,74.87%,1266,643,1909
"Justice, 14th Court of Appeals District, Place 3",0136,981,451,1432,2111,67.84%,46,1333,1379
"Justice, 14th Court of Appeals District, Place 3",0137,305,193,498,740,67.30%,240,210,450
"Justice, 14th Court of Appeals District, Place 3",0138,661,259,920,1749,52.60%,21,864,885
"Justice, 14th Court of Appeals District, Place 3",0139,1290,747,2037,2746,74.18%,963,900,1863
"Justice, 14th Court of Appeals District, Place 3",0140,1315,683,1998,3104,64.37%,277,1609,1886
"Justice, 14th Court of Appeals District, Place 3",0141,181,143,324,872,37.16%,191,114,305
"Justice, 14th Court of Appeals District, Place 3",0142,212,171,383,870,44.02%,89,269,358
"Justice, 14th Court of Appeals District, Place 3",0143,2994,660,3654,4598,79.47%,2508,1002,3510
"Justice, 14th Court of Appeals District, Place 3",0144,477,204,681,1143,59.58%,8,654,662
"Justice, 14th Court of Appeals District, Place 3",0145,663,245,908,1580,57.47%,14,875,889
"Justice, 14th Court of Appeals District, Place 3",0146,759,614,1373,1953,70.30%,582,688,1270
"Justice, 14th Court of Appeals District, Place 3",0147,1255,485,1740,2813,61.86%,203,1497,1700
"Justice, 14th Court of Appeals District, Place 3",0148,908,924,1832,2467,74.26%,744,942,1686
"Justice, 14th Court of Appeals District, Place 3",0149,2860,1322,4182,6103,68.52%,1819,2190,4009
"Justice, 14th Court of Appeals District, Place 3",0150,539,207,746,1212,61.55%,14,711,725
"Justice, 14th Court of Appeals District, Place 3",0151,316,148,464,846,54.85%,19,420,439
"Justice, 14th Court of Appeals District, Place 3",0152,483,602,1085,2701,40.17%,209,818,1027
"Justice, 14th Court of Appeals District, Place 3",0153,328,437,765,1755,43.59%,172,539,711
"Justice, 14th Court of Appeals District, Place 3",0154,593,360,953,2133,44.68%,184,675,859
"Justice, 14th Court of Appeals District, Place 3",0155,1957,834,2791,4087,68.29%,1826,820,2646
"Justice, 14th Court of Appeals District, Place 3",0156,1427,457,1884,3134,60.11%,45,1762,1807
"Justice, 14th Court of Appeals District, Place 3",0157,881,382,1263,2311,54.65%,37,1188,1225
"Justice, 14th Court of Appeals District, Place 3",0158,1304,435,1739,3016,57.66%,21,1681,1702
"Justice, 14th Court of Appeals District, Place 3",0159,313,187,500,976,51.23%,55,422,477
"Justice, 14th Court of Appeals District, Place 3",0160,246,140,386,688,56.10%,9,360,369
"Justice, 14th Court of Appeals District, Place 3",0161,395,190,585,1030,56.80%,7,562,569
"Justice, 14th Court of Appeals District, Place 3",0162,232,262,494,1249,39.55%,131,314,445
"Justice, 14th Court of Appeals District, Place 3",0163,778,635,1413,3054,46.27%,372,882,1254
"Justice, 14th Court of Appeals District, Place 3",0164,505,304,809,1434,56.42%,11,775,786
"Justice, 14th Court of Appeals District, Place 3",0165,918,557,1475,2284,64.58%,898,493,1391
"Justice, 14th Court of Appeals District, Place 3",0166,281,311,592,1016,58.27%,183,365,548
"Justice, 14th Court of Appeals District, Place 3",0167,5,2,7,23,30.43%,0,7,7
"Justice, 14th Court of Appeals District, Place 3",0168,188,126,314,519,60.50%,4,298,302
"Justice, 14th Court of Appeals District, Place 3",0169,1060,433,1493,2531,58.99%,22,1438,1460
"Justice, 14th Court of Appeals District, Place 3",0170,481,353,834,1887,44.20%,385,390,775
"Justice, 14th Court of Appeals District, Place 3",0171,514,294,808,1613,50.09%,26,753,779
"Justice, 14th Court of Appeals District, Place 3",0172,161,147,308,600,51.33%,94,188,282
"Justice, 14th Court of Appeals District, Place 3",0173,1798,619,2417,3105,77.84%,1814,488,2302
"Justice, 14th Court of Appeals District, Place 3",0174,1554,767,2321,3159,73.47%,1506,653,2159
"Justice, 14th Court of Appeals District, Place 3",0175,1065,867,1932,2506,77.09%,959,807,1766
"Justice, 14th Court of Appeals District, Place 3",0176,627,530,1157,1581,73.18%,584,464,1048
"Justice, 14th Court of Appeals District, Place 3",0177,672,385,1057,1478,71.52%,622,370,992
"Justice, 14th Court of Appeals District, Place 3",0178,914,368,1282,1718,74.62%,813,360,1173
"Justice, 14th Court of Appeals District, Place 3",0179,449,321,770,1508,51.06%,333,385,718
"Justice, 14th Court of Appeals District, Place 3",0180,966,552,1518,2795,54.31%,35,1418,1453
"Justice, 14th Court of Appeals District, Place 3",0181,416,514,930,1968,47.26%,250,617,867
"Justice, 14th Court of Appeals District, Place 3",0182,1321,1081,2402,3289,73.03%,1407,758,2165
"Justice, 14th Court of Appeals District, Place 3",0183,970,943,1913,2451,78.05%,1219,539,1758
"Justice, 14th Court of Appeals District, Place 3",0184,214,256,470,969,48.50%,123,312,435
"Justice, 14th Court of Appeals District, Place 3",0185,592,494,1086,1910,56.86%,323,693,1016
"Justice, 14th Court of Appeals District, Place 3",0186,204,170,374,795,47.04%,38,312,350
"Justice, 14th Court of Appeals District, Place 3",0187,48,65,113,309,36.57%,26,83,109
"Justice, 14th Court of Appeals District, Place 3",0188,307,378,685,1616,42.39%,229,419,648
"Justice, 14th Court of Appeals District, Place 3",0189,492,473,965,1453,66.41%,497,384,881
"Justice, 14th Court of Appeals District, Place 3",0190,275,401,676,1720,39.30%,226,407,633
"Justice, 14th Court of Appeals District, Place 3",0191,197,313,510,1391,36.66%,164,320,484
"Justice, 14th Court of Appeals District, Place 3",0192,746,332,1078,2045,52.71%,33,1011,1044
"Justice, 14th Court of Appeals District, Place 3",0193,341,269,610,1050,58.10%,10,578,588
"Justice, 14th Court of Appeals District, Place 3",0194,706,504,1210,1735,69.74%,343,781,1124
"Justice, 14th Court of Appeals District, Place 3",0195,539,419,958,1721,55.67%,25,896,921
"Justice, 14th Court of Appeals District, Place 3",0196,121,55,176,323,54.49%,7,162,169
"Justice, 14th Court of Appeals District, Place 3",0197,1109,497,1606,2895,55.47%,33,1526,1559
"Justice, 14th Court of Appeals District, Place 3",0198,143,158,301,657,45.81%,5,284,289
"Justice, 14th Court of Appeals District, Place 3",0199,1407,773,2180,3159,69.01%,1602,475,2077
"Justice, 14th Court of Appeals District, Place 3",0200,1638,585,2223,3222,68.99%,996,1044,2040
"Justice, 14th Court of Appeals District, Place 3",0201,229,1,25,354,728,48.63%,9,335,344
"Justice, 14th Court of Appeals District, Place 3",0202,488,332,820,1479,55.44%,10,775,785
"Justice, 14th Court of Appeals District, Place 3",0203,266,156,422,900,46.89%,80,318,398
"Justice, 14th Court of Appeals District, Place 3",0204,1491,914,2405,3462,69.47%,1350,882,2232
"Justice, 14th Court of Appeals District, Place 3",0205,856,201,1057,1667,63.41%,18,1008,1026
"Justice, 14th Court of Appeals District, Place 3",0206,651,659,1310,2662,49.21%,381,841,1222
"Justice, 14th Court of Appeals District, Place 3",0207,410,310,720,1144,62.94%,233,424,657
"Justice, 14th Court of Appeals District, Place 3",0208,806,364,1170,2201,53.16%,289,809,1098
"Justice, 14th Court of Appeals District, Place 3",0209,0,4,4,0,0.00%,4,0,4
"Justice, 14th Court of Appeals District, Place 3",0210,1013,542,1555,2300,67.61%,157,1320,1477
"Justice, 14th Court of Appeals District, Place 3",0211,710,686,1396,2797,49.91%,462,827,1289
"Justice, 14th Court of Appeals District, Place 3",0212,218,314,532,1266,42.02%,90,411,501
"Justice, 14th Court of Appeals District, Place 3",0213,1603,939,2542,3308,76.84%,1914,464,2378
"Justice, 14th Court of Appeals District, Place 3",0214,798,544,1342,1795,74.76%,797,428,1225
"Justice, 14th Court of Appeals District, Place 3",0215,844,786,1630,2168,75.18%,958,550,1508
"Justice, 14th Court of Appeals District, Place 3",0216,784,320,1104,1917,57.59%,77,989,1066
"Justice, 14th Court of Appeals District, Place 3",0217,1396,651,2047,2637,77.63%,1298,593,1891
"Justice, 14th Court of Appeals District, Place 3",0218,690,608,1298,2274,57.08%,359,835,1194
"Justice, 14th Court of Appeals District, Place 3",0219,1117,587,1704,2654,64.20%,131,1485,1616
"Justice, 14th Court of Appeals District, Place 3",0220,711,353,1064,2360,45.08%,707,297,1004
"Justice, 14th Court of Appeals District, Place 3",0221,699,611,1310,2489,52.63%,508,702,1210
"Justice, 14th Court of Appeals District, Place 3",0222,1000,792,1792,2384,75.17%,795,813,1608
"Justice, 14th Court of Appeals District, Place 3",0223,1350,760,2110,3528,59.81%,589,1355,1944
"Justice, 14th Court of Appeals District, Place 3",0224,896,649,1545,2259,68.39%,690,727,1417
"Justice, 14th Court of Appeals District, Place 3",0225,1111,720,1831,3155,58.03%,746,998,1744
"Justice, 14th Court of Appeals District, Place 3",0226,529,545,1074,2393,44.88%,199,786,985
"Justice, 14th Court of Appeals District, Place 3",0227,947,451,1398,1767,79.12%,1025,278,1303
"Justice, 14th Court of Appeals District, Place 3",0228,583,165,748,1073,69.71%,32,700,732
"Justice, 14th Court of Appeals District, Place 3",0229,152,207,359,811,44.27%,95,243,338
"Justice, 14th Court of Appeals District, Place 3",0230,421,153,574,1096,52.37%,9,542,551
"Justice, 14th Court of Appeals District, Place 3",0231,562,471,1033,2219,46.55%,234,741,975
"Justice, 14th Court of Appeals District, Place 3",0232,685,546,1231,1696,72.58%,665,466,1131
"Justice, 14th Court of Appeals District, Place 3",0233,1830,1063,2893,4132,70.01%,1458,1221,2679
"Justice, 14th Court of Appeals District, Place 3",0234,2090,885,2975,3854,77.19%,2187,587,2774
"Justice, 14th Court of Appeals District, Place 3",0235,466,242,708,1305,54.25%,17,670,687
"Justice, 14th Court of Appeals District, Place 3",0236,779,342,1121,2144,52.29%,20,1053,1073
"Justice, 14th Court of Appeals District, Place 3",0237,793,441,1234,2181,56.58%,15,1193,1208
"Justice, 14th Court of Appeals District, Place 3",0238,640,422,1062,1901,55.87%,14,1010,1024
"Justice, 14th Court of Appeals District, Place 3",0239,765,357,1122,1997,56.18%,26,1064,1090
"Justice, 14th Court of Appeals District, Place 3",0240,1157,402,1559,2688,58.00%,17,1496,1513
"Justice, 14th Court of Appeals District, Place 3",0241,494,479,973,2296,42.38%,358,564,922
"Justice, 14th Court of Appeals District, Place 3",0242,363,323,686,1570,43.69%,341,311,652
"Justice, 14th Court of Appeals District, Place 3",0243,254,50,304,452,67.26%,3,291,294
"Justice, 14th Court of Appeals District, Place 3",0244,1100,656,1756,2912,60.30%,891,792,1683
"Justice, 14th Court of Appeals District, Place 3",0245,2340,1115,3455,5240,65.94%,2258,1070,3328
"Justice, 14th Court of Appeals District, Place 3",0246,1584,624,2208,2999,73.62%,1441,665,2106
"Justice, 14th Court of Appeals District, Place 3",0247,421,403,824,1607,51.28%,12,791,803
"Justice, 14th Court of Appeals District, Place 3",0248,408,405,813,2122,38.31%,177,591,768
"Justice, 14th Court of Appeals District, Place 3",0249,1028,481,1509,2676,56.39%,958,480,1438
"Justice, 14th Court of Appeals District, Place 3",0250,306,247,553,951,58.15%,8,534,542
"Justice, 14th Court of Appeals District, Place 3",0251,809,529,1338,2072,64.58%,45,1242,1287
"Justice, 14th Court of Appeals District, Place 3",0252,1111,356,1467,2350,62.43%,19,1409,1428
"Justice, 14th Court of Appeals District, Place 3",0253,923,325,1248,2252,55.42%,15,1213,1228
"Justice, 14th Court of Appeals District, Place 3",0254,220,282,502,1476,34.01%,115,350,465
"Justice, 14th Court of Appeals District, Place 3",0255,995,797,1792,2411,74.33%,784,881,1665
"Justice, 14th Court of Appeals District, Place 3",0256,1059,766,1825,3226,56.57%,662,1024,1686
"Justice, 14th Court of Appeals District, Place 3",0257,553,571,1124,2403,46.77%,252,819,1071
"Justice, 14th Court of Appeals District, Place 3",0258,1577,888,2465,3286,75.02%,1712,561,2273
"Justice, 14th Court of Appeals District, Place 3",0259,1,1210,460,1670,2408,69.35%,29,1605,1634
"Justice, 14th Court of Appeals District, Place 3",0260,420,290,710,1187,59.81%,367,312,679
"Justice, 14th Court of Appeals District, Place 3",0261,176,133,309,749,41.26%,89,204,293
"Justice, 14th Court of Appeals District, Place 3",0262,1470,906,2376,4232,56.14%,1300,906,2206
"Justice, 14th Court of Appeals District, Place 3",0263,1785,719,2504,3319,75.44%,1814,583,2397
"Justice, 14th Court of Appeals District, Place 3",0264,936,639,1575,2939,53.59%,802,651,1453
"Justice, 14th Court of Appeals District, Place 3",0265,1936,674,2610,3617,72.16%,1847,578,2425
"Justice, 14th Court of Appeals District, Place 3",0266,552,542,1094,2119,51.63%,466,563,1029
"Justice, 14th Court of Appeals District, Place 3",0267,294,305,599,1346,44.50%,254,299,553
"Justice, 14th Court of Appeals District, Place 3",0268,931,810,1741,2387,72.94%,1013,575,1588
"Justice, 14th Court of Appeals District, Place 3",0269,1143,444,1587,1981,80.11%,1199,282,1481
"Justice, 14th Court of Appeals District, Place 3",0270,1401,870,2271,3517,64.57%,1230,871,2101
"Justice, 14th Court of Appeals District, Place 3",0271,1303,371,1674,2469,67.80%,12,1617,1629
"Justice, 14th Court of Appeals District, Place 3",0272,610,484,1094,2112,51.80%,394,647,1041
"Justice, 14th Court of Appeals District, Place 3",0273,1141,634,1775,2426,73.17%,1389,290,1679
"Justice, 14th Court of Appeals District, Place 3",0274,1049,364,1413,2063,68.49%,920,419,1339
"Justice, 14th Court of Appeals District, Place 3",0275,567,410,977,1730,56.47%,153,785,938
"Justice, 14th Court of Appeals District, Place 3",0276,1139,404,1543,2532,60.94%,11,1493,1504
"Justice, 14th Court of Appeals District, Place 3",0277,342,305,647,1473,43.92%,270,355,625
"Justice, 14th Court of Appeals District, Place 3",0278,756,607,1363,2405,56.67%,677,607,1284
"Justice, 14th Court of Appeals District, Place 3",0279,548,383,931,1899,49.03%,536,342,878
"Justice, 14th Court of Appeals District, Place 3",0280,303,360,663,1515,43.76%,217,402,619
"Justice, 14th Court of Appeals District, Place 3",0281,1087,903,1990,2610,76.25%,938,823,1761
"Justice, 14th Court of Appeals District, Place 3",0282,690,591,1281,1988,64.44%,731,477,1208
"Justice, 14th Court of Appeals District, Place 3",0283,0,0,0,0,0.00%,0,0,0
"Justice, 14th Court of Appeals District, Place 3",0284,1136,595,1731,3262,53.07%,608,1029,1637
"Justice, 14th Court of Appeals District, Place 3",0285,988,509,1497,2505,59.76%,96,1349,1445
"Justice, 14th Court of Appeals District, Place 3",0286,2658,1053,3711,5719,64.89%,296,3263,3559
"Justice, 14th Court of Appeals District, Place 3",0287,647,542,1189,1616,73.58%,591,518,1109
"Justice, 14th Court of Appeals District, Place 3",0288,1036,380,1416,2259,62.68%,19,1354,1373
"Justice, 14th Court of Appeals District, Place 3",0289,374,397,771,1510,51.06%,296,418,714
"Justice, 14th Court of Appeals District, Place 3",0290,577,429,1006,1567,64.20%,745,227,972
"Justice, 14th Court of Appeals District, Place 3",0291,541,298,839,1203,69.74%,384,400,784
"Justice, 14th Court of Appeals District, Place 3",0292,478,236,714,1272,56.13%,87,597,684
"Justice, 14th Court of Appeals District, Place 3",0293,620,557,1177,1733,67.92%,505,590,1095
"Justice, 14th Court of Appeals District, Place 3",0294,989,298,1287,2107,61.08%,11,1239,1250
"Justice, 14th Court of Appeals District, Place 3",0295,314,189,503,862,58.35%,6,486,492
"Justice, 14th Court of Appeals District, Place 3",0296,602,432,1034,1693,61.08%,562,378,940
"Justice, 14th Court of Appeals District, Place 3",0297,579,445,1024,1978,51.77%,354,602,956
"Justice, 14th Court of Appeals District, Place 3",0298,848,475,1323,2083,63.51%,693,540,1233
"Justice, 14th Court of Appeals District, Place 3",0299,328,213,541,1231,43.95%,166,343,509
"Justice, 14th Court of Appeals District, Place 3",0300,3014,922,3936,5040,78.10%,2937,772,3709
"Justice, 14th Court of Appeals District, Place 3",0301,450,655,1105,2397,46.10%,392,653,1045
"Justice, 14th Court of Appeals District, Place 3",0302,713,635,1348,2724,49.49%,692,570,1262
"Justice, 14th Court of Appeals District, Place 3",0303,1773,755,2528,3172,79.70%,1945,426,2371
"Justice, 14th Court of Appeals District, Place 3",0304,970,648,1618,2266,71.40%,869,608,1477
"Justice, 14th Court of Appeals District, Place 3",0305,1319,858,2177,3621,60.12%,768,1312,2080
"Justice, 14th Court of Appeals District, Place 3",0306,1013,323,1336,1847,72.33%,912,337,1249
"Justice, 14th Court of Appeals District, Place 3",0307,1242,876,2118,2931,72.26%,1400,593,1993
"Justice, 14th Court of Appeals District, Place 3",0308,444,238,682,1266,53.87%,176,465,641
"Justice, 14th Court of Appeals District, Place 3",0309,1385,612,1997,2529,78.96%,1525,350,1875
"Justice, 14th Court of Appeals District, Place 3",0310,619,348,967,1437,67.29%,611,293,904
"Justice, 14th Court of Appeals District, Place 3",0311,862,699,1561,2997,52.09%,647,753,1400
"Justice, 14th Court of Appeals District, Place 3",0312,1600,718,2318,3669,63.18%,1223,958,2181
"Justice, 14th Court of Appeals District, Place 3",0313,22,1,23,60,38.33%,11,9,20
"Justice, 14th Court of Appeals District, Place 3",0314,2494,1221,3715,5225,71.10%,2204,1364,3568
"Justice, 14th Court of Appeals District, Place 3",0315,711,479,1190,1618,73.55%,677,423,1100
"Justice, 14th Court of Appeals District, Place 3",0316,682,411,1093,1522,71.81%,573,429,1002
"Justice, 14th Court of Appeals District, Place 3",0317,552,336,888,1469,60.45%,258,589,847
"Justice, 14th Court of Appeals District, Place 3",0318,1708,611,2319,3531,65.68%,81,2153,2234
"Justice, 14th Court of Appeals District, Place 3",0319,965,290,1255,2081,60.31%,75,1131,1206
"Justice, 14th Court of Appeals District, Place 3",0320,464,300,764,1505,50.76%,320,397,717
"Justice, 14th Court of Appeals District, Place 3",0321,442,306,748,2029,36.87%,241,468,709
"Justice, 14th Court of Appeals District, Place 3",0322,397,237,634,1322,47.96%,158,455,613
"Justice, 14th Court of Appeals District, Place 3",0323,482,332,814,1719,47.35%,314,437,751
"Justice, 14th Court of Appeals District, Place 3",0324,967,718,1685,2339,72.04%,1039,517,1556
"Justice, 14th Court of Appeals District, Place 3",0325,657,397,1054,2251,46.82%,223,782,1005
"Justice, 14th Court of Appeals District, Place 3",0326,202,128,330,678,48.67%,130,173,303
"Justice, 14th Court of Appeals District, Place 3",0327,726,244,970,1751,55.40%,17,922,939
"Justice, 14th Court of Appeals District, Place 3",0328,344,270,614,1361,45.11%,216,368,584
"Justice, 14th Court of Appeals District, Place 3",0329,405,307,712,1367,52.08%,205,458,663
"Justice, 14th Court of Appeals District, Place 3",0330,590,376,966,1849,52.24%,418,480,898
"Justice, 14th Court of Appeals District, Place 3",0331,0,1,1,0,0.00%,1,0,1
"Justice, 14th Court of Appeals District, Place 3",0332,23,4,27,128,21.09%,9,16,25
"Justice, 14th Court of Appeals District, Place 3",0333,1018,939,1957,2901,67.46%,1349,503,1852
"Justice, 14th Court of Appeals District, Place 3",0334,255,114,369,755,48.87%,73,281,354
"Justice, 14th Court of Appeals District, Place 3",0335,285,246,531,1227,43.28%,148,328,476
"Justice, 14th Court of Appeals District, Place 3",0336,1820,588,2408,3161,76.18%,203,2128,2331
"Justice, 14th Court of Appeals District, Place 3",0337,310,207,517,951,54.36%,83,420,503
"Justice, 14th Court of Appeals District, Place 3",0338,1541,824,2365,4673,50.61%,638,1567,2205
"Justice, 14th Court of Appeals District, Place 3",0339,369,373,742,1716,43.24%,140,536,676
"Justice, 14th Court of Appeals District, Place 3",0340,1778,833,2611,3717,70.24%,1855,592,2447
"Justice, 14th Court of Appeals District, Place 3",0341,246,316,562,1248,45.03%,123,411,534
"Justice, 14th Court of Appeals District, Place 3",0342,2029,1113,3142,5718,54.95%,419,2625,3044
"Justice, 14th Court of Appeals District, Place 3",0343,436,483,919,1904,48.27%,206,623,829
"Justice, 14th Court of Appeals District, Place 3",0344,395,245,640,1207,53.02%,22,592,614
"Justice, 14th Court of Appeals District, Place 3",0345,428,357,785,1708,45.96%,155,589,744
"Justice, 14th Court of Appeals District, Place 3",0346,1,2,3,1,300.00%,3,0,3
"Justice, 14th Court of Appeals District, Place 3",0347,1250,614,1864,3299,56.50%,1104,674,1778
"Justice, 14th Court of Appeals District, Place 3",0348,751,280,1031,1740,59.25%,707,272,979
"Justice, 14th Court of Appeals District, Place 3",0349,405,407,812,1315,61.75%,460,311,771
"Justice, 14th Court of Appeals District, Place 3",0350,1115,780,1895,2906,65.21%,739,1001,1740
"Justice, 14th Court of Appeals District, Place 3",0351,2495,793,3288,4537,72.47%,2517,640,3157
"Justice, 14th Court of Appeals District, Place 3",0352,1152,583,1735,3193,54.34%,1158,500,1658
"Justice, 14th Court of Appeals District, Place 3",0353,1544,703,2247,3697,60.78%,362,1798,2160
"Justice, 14th Court of Appeals District, Place 3",0354,1476,517,1993,3193,62.42%,427,1479,1906
"Justice, 14th Court of Appeals District, Place 3",0355,701,286,987,1384,71.32%,88,869,957
"Justice, 14th Court of Appeals District, Place 3",0356,1382,618,2000,2836,70.52%,1117,747,1864
"Justice, 14th Court of Appeals District, Place 3",0357,1633,709,2342,3371,69.47%,1677,548,2225
"Justice, 14th Court of Appeals District, Place 3",0358,740,464,1204,2297,52.42%,84,1077,1161
"Justice, 14th Court of Appeals District, Place 3",0359,706,482,1188,3008,39.49%,92,1055,1147
"Justice, 14th Court of Appeals District, Place 3",0360,971,515,1486,2190,67.85%,780,571,1351
"Justice, 14th Court of Appeals District, Place 3",0361,135,691,826,1585,52.11%,147,554,701
"Justice, 14th Court of Appeals District, Place 3",0362,2131,1200,3331,4952,67.27%,2349,803,3152
"Justice, 14th Court of Appeals District, Place 3",0363,1347,687,2034,3291,61.80%,862,1104,1966
"Justice, 14th Court of Appeals District, Place 3",0364,912,602,1514,2539,59.63%,729,706,1435
"Justice, 14th Court of Appeals District, Place 3",0365,735,245,980,1302,75.27%,79,874,953
"Justice, 14th Court of Appeals District, Place 3",0366,638,466,1104,2089,52.85%,221,845,1066
"Justice, 14th Court of Appeals District, Place 3",0367,328,212,540,1019,52.99%,93,426,519
"Justice, 14th Court of Appeals District, Place 3",0368,418,143,561,929,60.39%,140,403,543
"Justice, 14th Court of Appeals District, Place 3",0369,107,53,160,490,32.65%,56,98,154
"Justice, 14th Court of Appeals District, Place 3",0370,3144,1178,4322,5781,74.76%,3184,944,4128
"Justice, 14th Court of Appeals District, Place 3",0371,226,69,295,475,62.11%,5,281,286
"Justice, 14th Court of Appeals District, Place 3",0372,498,231,729,1215,60.00%,74,624,698
"Justice, 14th Court of Appeals District, Place 3",0373,61,16,77,159,48.43%,1,75,76
"Justice, 14th Court of Appeals District, Place 3",0374,139,187,326,748,43.58%,87,220,307
"Justice, 14th Court of Appeals District, Place 3",0375,577,524,1101,2607,42.23%,427,613,1040
"Justice, 14th Court of Appeals District, Place 3",0376,629,334,963,1916,50.26%,380,525,905
"Justice, 14th Court of Appeals District, Place 3",0377,1055,707,1762,2871,61.37%,1263,386,1649
"Justice, 14th Court of Appeals District, Place 3",0378,559,521,1080,1777,60.78%,649,379,1028
"Justice, 14th Court of Appeals District, Place 3",0379,801,338,1139,2017,56.47%,75,1017,1092
"Justice, 14th Court of Appeals District, Place 3",0380,2502,1183,3685,4753,77.53%,2041,1469,3510
"Justice, 14th Court of Appeals District, Place 3",0381,957,424,1381,2715,50.87%,541,776,1317
"Justice, 14th Court of Appeals District, Place 3",0382,276,231,507,841,60.29%,346,136,482
"Justice, 14th Court of Appeals District, Place 3",0383,599,493,1092,2076,52.60%,324,715,1039
"Justice, 14th Court of Appeals District, Place 3",0384,1173,505,1678,2596,64.64%,325,1286,1611
"Justice, 14th Court of Appeals District, Place 3",0385,1099,621,1720,2175,79.08%,1240,359,1599
"Justice, 14th Court of Appeals District, Place 3",0386,1464,460,1924,2872,66.99%,1346,493,1839
"Justice, 14th Court of Appeals District, Place 3",0387,1369,802,2171,3727,58.25%,1434,623,2057
"Justice, 14th Court of Appeals District, Place 3",0388,2780,1222,4002,5329,75.10%,2176,1661,3837
"Justice, 14th Court of Appeals District, Place 3",0389,285,261,546,975,56.00%,86,424,510
"Justice, 14th Court of Appeals District, Place 3",0390,644,368,1012,1565,64.66%,116,849,965
"Justice, 14th Court of Appeals District, Place 3",0391,856,355,1211,1805,67.09%,736,410,1146
"Justice, 14th Court of Appeals District, Place 3",0392,737,197,934,1441,64.82%,7,906,913
"Justice, 14th Court of Appeals District, Place 3",0393,346,318,664,1206,55.06%,275,349,624
"Justice, 14th Court of Appeals District, Place 3",0394,166,176,342,860,39.77%,126,197,323
"Justice, 14th Court of Appeals District, Place 3",0395,830,491,1321,1820,72.58%,884,350,1234
"Justice, 14th Court of Appeals District, Place 3",0396,1157,219,1376,2073,66.38%,13,1321,1334
"Justice, 14th Court of Appeals District, Place 3",0397,163,148,311,750,41.47%,114,175,289
"Justice, 14th Court of Appeals District, Place 3",0398,1439,840,2279,3816,59.72%,1076,1106,2182
"Justice, 14th Court of Appeals District, Place 3",0399,897,593,1490,2542,58.62%,697,743,1440
"Justice, 14th Court of Appeals District, Place 3",0400,1051,506,1557,2238,69.57%,1068,401,1469
"Justice, 14th Court of Appeals District, Place 3",0401,723,284,1007,1876,53.68%,39,942,981
"Justice, 14th Court of Appeals District, Place 3",0402,892,245,1137,1737,65.46%,51,1055,1106
"Justice, 14th Court of Appeals District, Place 3",0403,791,527,1318,1703,77.39%,705,484,1189
"Justice, 14th Court of Appeals District, Place 3",0404,778,552,1330,2589,51.37%,656,600,1256
"Justice, 14th Court of Appeals District, Place 3",0405,0,1,1,0,0.00%,0,1,1
"Justice, 14th Court of Appeals District, Place 3",0406,281,72,353,610,57.87%,7,330,337
"Justice, 14th Court of Appeals District, Place 3",0407,1317,1000,2317,3652,63.44%,1394,766,2160
"Justice, 14th Court of Appeals District, Place 3",0408,154,179,333,933,35.69%,130,181,311
"Justice, 14th Court of Appeals District, Place 3",0409,277,289,566,1371,41.28%,161,366,527
"Justice, 14th Court of Appeals District, Place 3",0410,337,102,439,849,51.71%,83,342,425
"Justice, 14th Court of Appeals District, Place 3",0411,542,462,1004,2302,43.61%,276,660,936
"Justice, 14th Court of Appeals District, Place 3",0412,193,74,267,433,61.66%,9,251,260
"Justice, 14th Court of Appeals District, Place 3",0413,1493,525,2018,3023,66.75%,733,1169,1902
"Justice, 14th Court of Appeals District, Place 3",0414,1452,593,2045,3457,59.16%,1403,506,1909
"Justice, 14th Court of Appeals District, Place 3",0415,950,633,1583,2124,74.53%,1040,444,1484
"Justice, 14th Court of Appeals District, Place 3",0416,1177,916,2093,3582,58.43%,1032,938,1970
"Justice, 14th Court of Appeals District, Place 3",0417,777,619,1396,2465,56.63%,584,738,1322
"Justice, 14th Court of Appeals District, Place 3",0418,1057,758,1815,3420,53.07%,634,1081,1715
"Justice, 14th Court of Appeals District, Place 3",0419,1006,578,1584,2697,58.73%,970,536,1506
"Justice, 14th Court of Appeals District, Place 3",0420,2174,1089,3263,4639,70.34%,2589,508,3097
"Justice, 14th Court of Appeals District, Place 3",0421,124,92,216,467,46.25%,43,165,208
"Justice, 14th Court of Appeals District, Place 3",0422,1456,585,2041,3345,61.02%,41,1944,1985
"Justice, 14th Court of Appeals District, Place 3",0423,190,309,499,894,55.82%,198,264,462
"Justice, 14th Court of Appeals District, Place 3",0424,435,1,57,592,888,66.67%,325,249,574
"Justice, 14th Court of Appeals District, Place 3",0425,227,234,461,875,52.69%,145,288,433
"Justice, 14th Court of Appeals District, Place 3",0426,415,283,698,1224,57.03%,367,270,637
"Justice, 14th Court of Appeals District, Place 3",0427,325,249,574,1115,51.48%,196,338,534
"Justice, 14th Court of Appeals District, Place 3",0428,1284,907,2191,4316,50.76%,616,1430,2046
"Justice, 14th Court of Appeals District, Place 3",0429,1093,777,1870,3929,47.59%,329,1397,1726
"Justice, 14th Court of Appeals District, Place 3",0430,405,335,740,1654,44.74%,144,538,682
"Justice, 14th Court of Appeals District, Place 3",0431,820,403,1223,3188,38.36%,307,843,1150
"Justice, 14th Court of Appeals District, Place 3",0432,312,271,583,1344,43.38%,155,400,555
"Justice, 14th Court of Appeals District, Place 3",0433,139,106,245,573,42.76%,40,193,233
"Justice, 14th Court of Appeals District, Place 3",0434,628,371,999,1386,72.08%,606,328,934
"Justice, 14th Court of Appeals District, Place 3",0435,1534,768,2302,3097,74.33%,1458,693,2151
"Justice, 14th Court of Appeals District, Place 3",0436,1334,709,2043,3012,67.83%,1159,744,1903
"Justice, 14th Court of Appeals District, Place 3",0437,951,542,1493,2007,74.39%,1009,389,1398
"Justice, 14th Court of Appeals District, Place 3",0438,1046,387,1433,1802,79.52%,1016,303,1319
"Justice, 14th Court of Appeals District, Place 3",0439,1526,905,2431,3416,71.17%,1647,617,2264
"Justice, 14th Court of Appeals District, Place 3",0440,1326,876,2202,2867,76.81%,1665,383,2048
"Justice, 14th Court of Appeals District, Place 3",0441,698,513,1211,1616,74.94%,862,271,1133
"Justice, 14th Court of Appeals District, Place 3",0442,1366,513,1879,2504,75.04%,1484,305,1789
"Justice, 14th Court of Appeals District, Place 3",0443,335,148,483,605,79.83%,341,104,445
"Justice, 14th Court of Appeals District, Place 3",0444,1258,731,1989,3172,62.70%,1139,711,1850
"Justice, 14th Court of Appeals District, Place 3",0445,860,443,1303,1938,67.23%,768,450,1218
"Justice, 14th Court of Appeals District, Place 3",0446,70,52,122,268,45.52%,42,73,115
"Justice, 14th Court of Appeals District, Place 3",0447,271,108,379,583,65.01%,124,226,350
"Justice, 14th Court of Appeals District, Place 3",0448,1239,869,2108,3081,68.42%,1188,752,1940
"Justice, 14th Court of Appeals District, Place 3",0449,62,37,99,164,60.37%,11,82,93
"Justice, 14th Court of Appeals District, Place 3",0450,856,537,1393,2622,53.13%,335,994,1329
"Justice, 14th Court of Appeals District, Place 3",0451,1575,515,2090,2674,78.16%,1643,351,1994
"Justice, 14th Court of Appeals District, Place 3",0452,1109,639,1748,2810,62.21%,1262,418,1680
"Justice, 14th Court of Appeals District, Place 3",0453,559,475,1034,1885,54.85%,326,644,970
"Justice, 14th Court of Appeals District, Place 3",0454,1227,311,1538,2571,59.82%,9,1484,1493
"Justice, 14th Court of Appeals District, Place 3",0455,748,216,964,1679,57.42%,27,902,929
"Justice, 14th Court of Appeals District, Place 3",0456,1266,593,1859,3350,55.49%,952,805,1757
"Justice, 14th Court of Appeals District, Place 3",0457,0,0,0,0,0.00%,0,0,0
"Justice, 14th Court of Appeals District, Place 3",0458,909,271,1180,1893,62.33%,46,1093,1139
"Justice, 14th Court of Appeals District, Place 3",0459,1637,476,2113,2950,71.63%,1612,389,2001
"Justice, 14th Court of Appeals District, Place 3",0460,1250,402,1652,2346,70.42%,412,1169,1581
"Justice, 14th Court of Appeals District, Place 3",0461,1959,828,2787,3733,74.66%,1734,842,2576
"Justice, 14th Court of Appeals District, Place 3",0462,1319,865,2184,3367,64.86%,739,1300,2039
"Justice, 14th Court of Appeals District, Place 3",0463,1124,656,1780,2962,60.09%,689,1004,1693
"Justice, 14th Court of Appeals District, Place 3",0464,787,612,1399,2126,65.80%,923,403,1326
"Justice, 14th Court of Appeals District, Place 3",0465,1465,702,2167,3343,64.82%,1098,1006,2104
"Justice, 14th Court of Appeals District, Place 3",0466,2052,729,2781,4072,68.30%,1498,1171,2669
"Justice, 14th Court of Appeals District, Place 3",0467,478,229,707,1230,57.48%,161,512,673
"Justice, 14th Court of Appeals District, Place 3",0468,985,793,1778,3354,53.01%,491,1190,1681
"Justice, 14th Court of Appeals District, Place 3",0469,2039,638,2677,3779,70.84%,2008,532,2540
"Justice, 14th Court of Appeals District, Place 3",0470,443,323,766,1349,56.78%,515,206,721
"Justice, 14th Court of Appeals District, Place 3",0471,792,597,1389,2349,59.13%,1030,301,1331
"Justice, 14th Court of Appeals District, Place 3",0472,371,337,708,1027,68.94%,314,331,645
"Justice, 14th Court of Appeals District, Place 3",0473,914,442,1356,1827,74.22%,890,376,1266
"Justice, 14th Court of Appeals District, Place 3",0474,1146,766,1912,3006,63.61%,1264,547,1811
"Justice, 14th Court of Appeals District, Place 3",0475,485,473,958,1651,58.03%,397,500,897
"Justice, 14th Court of Appeals District, Place 3",0476,809,658,1467,2412,60.82%,795,603,1398
"Justice, 14th Court of Appeals District, Place 3",0477,1441,742,2183,3195,68.33%,1579,512,2091
"Justice, 14th Court of Appeals District, Place 3",0478,1959,898,2857,4150,68.84%,1810,901,2711
"Justice, 14th Court of Appeals District, Place 3",0479,1298,588,1886,2648,71.22%,1328,479,1807
"Justice, 14th Court of Appeals District, Place 3",0480,936,555,1491,2267,65.77%,1008,400,1408
"Justice, 14th Court of Appeals District, Place 3",0481,1464,852,2316,3298,70.22%,1661,532,2193
"Justice, 14th Court of Appeals District, Place 3",0482,1964,836,2800,4129,67.81%,1865,817,2682
"Justice, 14th Court of Appeals District, Place 3",0483,1868,759,2627,4141,63.44%,1341,1155,2496
"Justice, 14th Court of Appeals District, Place 3",0484,2237,1008,3245,4594,70.64%,2231,863,3094
"Justice, 14th Court of Appeals District, Place 3",0485,2421,990,3411,4838,70.50%,2452,818,3270
"Justice, 14th Court of Appeals District, Place 3",0486,1843,805,2648,3572,74.13%,1995,532,2527
"Justice, 14th Court of Appeals District, Place 3",0487,1005,612,1617,3318,48.73%,451,1038,1489
"Justice, 14th Court of Appeals District, Place 3",0488,580,440,1020,1713,59.54%,325,617,942
"Justice, 14th Court of Appeals District, Place 3",0489,784,378,1162,1823,63.74%,307,788,1095
"Justice, 14th Court of Appeals District, Place 3",0490,877,439,1316,1944,67.70%,453,780,1233
"Justice, 14th Court of Appeals District, Place 3",0491,667,489,1156,1782,64.87%,635,443,1078
"Justice, 14th Court of Appeals District, Place 3",0492,1070,504,1574,2351,66.95%,787,674,1461
"Justice, 14th Court of Appeals District, Place 3",0493,858,400,1258,1804,69.73%,775,394,1169
"Justice, 14th Court of Appeals District, Place 3",0494,761,431,1192,2176,54.78%,135,1016,1151
"Justice, 14th Court of Appeals District, Place 3",0495,1120,494,1614,2284,70.67%,1100,425,1525
"Justice, 14th Court of Appeals District, Place 3",0496,496,571,1067,2086,51.15%,371,627,998
"Justice, 14th Court of Appeals District, Place 3",0497,1124,303,1427,2226,64.11%,47,1333,1380
"Justice, 14th Court of Appeals District, Place 3",0498,759,499,1258,2123,59.26%,497,701,1198
"Justice, 14th Court of Appeals District, Place 3",0499,1301,517,1818,2304,78.91%,1274,429,1703
"Justice, 14th Court of Appeals District, Place 3",0500,1507,746,2253,3175,70.96%,1476,667,2143
"Justice, 14th Court of Appeals District, Place 3",0501,653,487,1140,1647,69.22%,425,627,1052
"Justice, 14th Court of Appeals District, Place 3",0502,1151,332,1483,2364,62.73%,1105,300,1405
"Justice, 14th Court of Appeals District, Place 3",0503,359,273,632,1363,46.37%,182,403,585
"Justice, 14th Court of Appeals District, Place 3",0504,1129,538,1667,2197,75.88%,1041,532,1573
"Justice, 14th Court of Appeals District, Place 3",0505,1209,829,2038,3654,55.77%,867,1034,1901
"Justice, 14th Court of Appeals District, Place 3",0506,1471,801,2272,3380,67.22%,343,1840,2183
"Justice, 14th Court of Appeals District, Place 3",0507,582,385,967,2435,39.71%,141,694,835
"Justice, 14th Court of Appeals District, Place 3",0508,946,760,1706,3248,52.52%,520,1053,1573
"Justice, 14th Court of Appeals District, Place 3",0509,1340,864,2204,3536,62.33%,1481,610,2091
"Justice, 14th Court of Appeals District, Place 3",0510,1492,682,2174,3511,61.92%,927,1124,2051
"Justice, 14th Court of Appeals District, Place 3",0511,0,6,6,0,0.00%,1,5,6
"Justice, 14th Court of Appeals District, Place 3",0512,1560,1127,2687,4582,58.64%,1177,1397,2574
"Justice, 14th Court of Appeals District, Place 3",0513,1605,507,2112,2752,76.74%,1541,462,2003
"Justice, 14th Court of Appeals District, Place 3",0514,1967,860,2827,3941,71.73%,2006,696,2702
"Justice, 14th Court of Appeals District, Place 3",0515,1692,708,2400,3173,75.64%,1863,411,2274
"Justice, 14th Court of Appeals District, Place 3",0516,2179,1066,3245,4934,65.77%,1534,1534,3068
"Justice, 14th Court of Appeals District, Place 3",0517,1208,653,1861,3320,56.05%,933,833,1766
"Justice, 14th Court of Appeals District, Place 3",0518,1478,919,2397,3755,63.83%,1451,818,2269
"Justice, 14th Court of Appeals District, Place 3",0519,1234,645,1879,2951,63.67%,1314,487,1801
"Justice, 14th Court of Appeals District, Place 3",0520,1542,857,2399,4064,59.03%,370,1941,2311
"Justice, 14th Court of Appeals District, Place 3",0521,1014,694,1708,2725,62.68%,824,800,1624
"Justice, 14th Court of Appeals District, Place 3",0522,1171,658,1829,2682,68.20%,1326,415,1741
"Justice, 14th Court of Appeals District, Place 3",0523,1339,689,2028,3060,66.27%,1302,586,1888
"Justice, 14th Court of Appeals District, Place 3",0524,1238,675,1913,3292,58.11%,534,1292,1826
"Justice, 14th Court of Appeals District, Place 3",0525,1381,610,1991,2947,67.56%,373,1522,1895
"Justice, 14th Court of Appeals District, Place 3",0526,167,171,338,731,46.24%,78,241,319
"Justice, 14th Court of Appeals District, Place 3",0527,80,24,104,569,18.28%,44,54,98
"Justice, 14th Court of Appeals District, Place 3",0528,36,12,48,92,52.17%,3,44,47
"Justice, 14th Court of Appeals District, Place 3",0529,1988,441,2429,3616,67.17%,1969,356,2325
"Justice, 14th Court of Appeals District, Place 3",0530,259,235,494,1196,41.30%,91,368,459
"Justice, 14th Court of Appeals District, Place 3",0531,672,113,785,1094,71.76%,591,147,738
"Justice, 14th Court of Appeals District, Place 3",0532,452,184,636,1039,61.21%,417,193,610
"Justice, 14th Court of Appeals District, Place 3",0533,317,207,524,1069,49.02%,252,243,495
"Justice, 14th Court of Appeals District, Place 3",0534,1658,675,2333,3795,61.48%,1624,592,2216
"Justice, 14th Court of Appeals District, Place 3",0535,80,94,174,421,41.33%,57,105,162
"Justice, 14th Court of Appeals District, Place 3",0536,1332,1195,2527,4576,55.22%,889,1511,2400
"Justice, 14th Court of Appeals District, Place 3",0537,1454,823,2277,2971,76.64%,1601,562,2163
"Justice, 14th Court of Appeals District, Place 3",0538,433,237,670,1282,52.26%,18,632,650
"Justice, 14th Court of Appeals District, Place 3",0539,26,209,235,71,330.99%,43,169,212
"Justice, 14th Court of Appeals District, Place 3",0540,666,380,1046,1491,70.15%,425,522,947
"Justice, 14th Court of Appeals District, Place 3",0541,1826,779,2605,4183,62.28%,339,2152,2491
"Justice, 14th Court of Appeals District, Place 3",0542,997,501,1498,2525,59.33%,78,1366,1444
"Justice, 14th Court of Appeals District, Place 3",0543,287,378,665,1528,43.52%,192,434,626
"Justice, 14th Court of Appeals District, Place 3",0544,92,53,145,318,45.60%,16,126,142
"Justice, 14th Court of Appeals District, Place 3",0545,1314,857,2171,3339,65.02%,998,1064,2062
"Justice, 14th Court of Appeals District, Place 3",0546,4,4,8,30,26.67%,2,5,7
"Justice, 14th Court of Appeals District, Place 3",0547,877,647,1524,2408,63.29%,1015,434,1449
"Justice, 14th Court of Appeals District, Place 3",0548,720,476,1196,2129,56.18%,514,632,1146
"Justice, 14th Court of Appeals District, Place 3",0549,944,586,1530,2530,60.47%,200,1273,1473
"Justice, 14th Court of Appeals District, Place 3",0550,1134,629,1763,2847,61.92%,832,870,1702
"Justice, 14th Court of Appeals District, Place 3",0551,3088,1527,4615,6135,75.22%,3245,1144,4389
"Justice, 14th Court of Appeals District, Place 3",0552,1621,844,2465,3241,76.06%,1970,381,2351
"Justice, 14th Court of Appeals District, Place 3",0553,1465,951,2416,4355,55.48%,1001,1313,2314
"Justice, 14th Court of Appeals District, Place 3",0554,562,340,902,1731,52.11%,133,710,843
"Justice, 14th Court of Appeals District, Place 3",0555,598,447,1045,2119,49.32%,168,825,993
"Justice, 14th Court of Appeals District, Place 3",0556,584,421,1005,2249,44.69%,197,759,956
"Justice, 14th Court of Appeals District, Place 3",0557,822,556,1378,2726,50.55%,413,854,1267
"Justice, 14th Court of Appeals District, Place 3",0558,1589,824,2413,4084,59.08%,725,1566,2291
"Justice, 14th Court of Appeals District, Place 3",0559,1787,899,2686,4633,57.98%,612,1930,2542
"Justice, 14th Court of Appeals District, Place 3",0560,172,289,461,1176,39.20%,78,346,424
"Justice, 14th Court of Appeals District, Place 3",0561,837,759,1596,3033,52.62%,838,680,1518
"Justice, 14th Court of Appeals District, Place 3",0562,201,146,347,645,53.80%,22,310,332
"Justice, 14th Court of Appeals District, Place 3",0563,1699,415,2114,2969,71.20%,1581,414,1995
"Justice, 14th Court of Appeals District, Place 3",0564,1150,713,1863,3096,60.17%,480,1250,1730
"Justice, 14th Court of Appeals District, Place 3",0565,315,194,509,1373,37.07%,86,391,477
"Justice, 14th Court of Appeals District, Place 3",0566,1123,478,1601,2950,54.27%,404,1133,1537
"Justice, 14th Court of Appeals District, Place 3",0567,672,394,1066,2198,48.50%,263,708,971
"Justice, 14th Court of Appeals District, Place 3",0568,1628,837,2465,3487,70.69%,1521,762,2283
"Justice, 14th Court of Appeals District, Place 3",0569,1294,865,2159,3249,66.45%,1116,881,1997
"Justice, 14th Court of Appeals District, Place 3",0570,527,409,936,1473,63.54%,396,457,853
"Justice, 14th Court of Appeals District, Place 3",0571,333,312,645,1758,36.69%,188,410,598
"Justice, 14th Court of Appeals District, Place 3",0572,1283,574,1857,2998,61.94%,845,919,1764
"Justice, 14th Court of Appeals District, Place 3",0573,578,368,946,1618,58.47%,10,916,926
"Justice, 14th Court of Appeals District, Place 3",0574,98,79,177,391,45.27%,18,148,166
"Justice, 14th Court of Appeals District, Place 3",0575,27,9,36,79,45.57%,32,3,35
"Justice, 14th Court of Appeals District, Place 3",0576,1051,552,1603,2671,60.01%,43,1509,1552
"Justice, 14th Court of Appeals District, Place 3",0577,231,113,344,573,60.03%,181,143,324
"Justice, 14th Court of Appeals District, Place 3",0578,745,553,1298,1689,76.85%,769,416,1185
"Justice, 14th Court of Appeals District, Place 3",0579,488,351,839,1806,46.46%,182,608,790
"Justice, 14th Court of Appeals District, Place 3",0580,429,146,575,1027,55.99%,12,548,560
"Justice, 14th Court of Appeals District, Place 3",0581,510,162,672,1041,64.55%,17,634,651
"Justice, 14th Court of Appeals District, Place 3",0582,615,256,871,1613,54.00%,45,797,842
"Justice, 14th Court of Appeals District, Place 3",0583,544,127,671,1248,53.77%,14,645,659
"Justice, 14th Court of Appeals District, Place 3",0584,392,139,531,971,54.69%,29,497,526
"Justice, 14th Court of Appeals District, Place 3",0585,934,304,1238,2403,51.52%,33,1170,1203
"Justice, 14th Court of Appeals District, Place 3",0585,1306,1189,2495,4230,58.98%,1453,939,2392
"Justice, 14th Court of Appeals District, Place 3",0587,933,465,1398,2174,64.31%,471,876,1347
"Justice, 14th Court of Appeals District, Place 3",0588,1536,871,2407,3468,69.41%,1651,656,2307
"Justice, 14th Court of Appeals District, Place 3",0589,1033,738,1771,3130,56.58%,895,798,1693
"Justice, 14th Court of Appeals District, Place 3",0590,1158,463,1621,2136,75.89%,1200,340,1540
"Justice, 14th Court of Appeals District, Place 3",0591,420,449,869,2114,41.11%,209,608,817
"Justice, 14th Court of Appeals District, Place 3",0592,370,288,658,1258,52.31%,141,488,629
"Justice, 14th Court of Appeals District, Place 3",0593,1149,999,2148,4059,52.92%,935,1110,2045
"Justice, 14th Court of Appeals District, Place 3",0594,1031,535,1566,2361,66.33%,431,1083,1514
"Justice, 14th Court of Appeals District, Place 3",0595,497,380,877,1647,53.25%,131,717,848
"Justice, 14th Court of Appeals District, Place 3",0596,946,690,1636,2848,57.44%,813,755,1568
"Justice, 14th Court of Appeals District, Place 3",0597,1067,719,1786,3267,54.67%,590,1129,1719
"Justice, 14th Court of Appeals District, Place 3",0598,335,103,438,724,60.50%,328,80,408
"Justice, 14th Court of Appeals District, Place 3",0599,1895,866,2761,4135,66.77%,890,1762,2652
"Justice, 14th Court of Appeals District, Place 3",0600,1383,869,2252,3820,58.95%,754,1393,2147
"Justice, 14th Court of Appeals District, Place 3",0601,2028,858,2886,3990,72.33%,2106,665,2771
"Justice, 14th Court of Appeals District, Place 3",0602,562,296,858,1237,69.36%,578,250,828
"Justice, 14th Court of Appeals District, Place 3",0603,1438,1163,2601,3917,66.40%,1524,983,2507
"Justice, 14th Court of Appeals District, Place 3",0604,1444,528,1972,2910,67.77%,1579,310,1889
"Justice, 14th Court of Appeals District, Place 3",0605,2227,889,3116,5251,59.34%,696,2300,2996
"Justice, 14th Court of Appeals District, Place 3",0606,420,122,542,1053,51.47%,5,520,525
"Justice, 14th Court of Appeals District, Place 3",0607,194,118,312,731,42.68%,19,278,297
"Justice, 14th Court of Appeals District, Place 3",0608,245,290,535,1256,42.60%,194,305,499
"Justice, 14th Court of Appeals District, Place 3",0609,1364,844,2208,3261,67.71%,1311,763,2074
"Justice, 14th Court of Appeals District, Place 3",0610,403,398,801,1825,43.89%,324,427,751
"Justice, 14th Court of Appeals District, Place 3",0611,1121,301,1422,2450,58.04%,36,1356,1392
"Justice, 14th Court of Appeals District, Place 3",0612,1700,579,2279,3272,69.65%,1660,486,2146
"Justice, 14th Court of Appeals District, Place 3",0613,495,309,804,1450,55.45%,122,654,776
"Justice, 14th Court of Appeals District, Place 3",0614,1631,812,2443,3932,62.13%,767,1568,2335
"Justice, 14th Court of Appeals District, Place 3",0615,931,404,1335,1926,69.31%,759,515,1274
"Justice, 14th Court of Appeals District, Place 3",0616,1352,970,2322,3378,68.74%,1540,662,2202
"Justice, 14th Court of Appeals District, Place 3",0617,1320,849,2169,3546,61.17%,740,1342,2082
"Justice, 14th Court of Appeals District, Place 3",0618,1922,1021,2943,5344,55.07%,1233,1584,2817
"Justice, 14th Court of Appeals District, Place 3",0619,2133,857,2990,4266,70.09%,2153,698,2851
"Justice, 14th Court of Appeals District, Place 3",0620,2384,856,3240,5271,61.47%,1496,1545,3041
"Justice, 14th Court of Appeals District, Place 3",0621,397,203,600,1173,51.15%,284,286,570
"Justice, 14th Court of Appeals District, Place 3",0622,1722,829,2551,4305,59.26%,1423,1010,2433
"Justice, 14th Court of Appeals District, Place 3",0623,1708,626,2334,3481,67.05%,1420,781,2201
"Justice, 14th Court of Appeals District, Place 3",0624,9,0,9,16,56.25%,4,5,9
"Justice, 14th Court of Appeals District, Place 3",0625,862,454,1316,1796,73.27%,702,507,1209
"Justice, 14th Court of Appeals District, Place 3",0626,1148,655,1803,2838,63.53%,847,847,1694
"Justice, 14th Court of Appeals District, Place 3",0627,795,647,1442,2964,48.65%,388,969,1357
"Justice, 14th Court of Appeals District, Place 3",0628,292,456,748,1600,46.75%,297,411,708
"Justice, 14th Court of Appeals District, Place 3",0629,175,127,302,629,48.01%,19,278,297
"Justice, 14th Court of Appeals District, Place 3",0630,2019,535,2554,3190,80.06%,211,2258,2469
"Justice, 14th Court of Appeals District, Place 3",0631,1489,392,1881,2733,68.83%,1290,498,1788
"Justice, 14th Court of Appeals District, Place 3",0632,12,9,21,231,9.09%,3,15,18
"Justice, 14th Court of Appeals District, Place 3",0633,1782,678,2460,3257,75.53%,1734,618,2352
"Justice, 14th Court of Appeals District, Place 3",0634,1020,734,1754,2922,60.03%,1054,621,1675
"Justice, 14th Court of Appeals District, Place 3",0635,1327,706,2033,3280,61.98%,1519,433,1952
"Justice, 14th Court of Appeals District, Place 3",0636,1791,974,2765,3881,71.24%,2316,347,2663
"Justice, 14th Court of Appeals District, Place 3",0637,739,509,1248,2471,50.51%,285,867,1152
"Justice, 14th Court of Appeals District, Place 3",0638,740,684,1424,2078,68.53%,85,1277,1362
"Justice, 14th Court of Appeals District, Place 3",0639,829,711,1540,2501,61.58%,1175,307,1482
"Justice, 14th Court of Appeals District, Place 3",0640,1382,723,2105,3548,59.33%,1164,849,2013
"Justice, 14th Court of Appeals District, Place 3",0641,1265,878,2143,3375,63.50%,1268,779,2047
"Justice, 14th Court of Appeals District, Place 3",0642,873,447,1320,1779,74.20%,1035,225,1260
"Justice, 14th Court of Appeals District, Place 3",0643,2157,994,3151,5310,59.34%,1157,1845,3002
"Justice, 14th Court of Appeals District, Place 3",0644,2123,1204,3327,5261,63.24%,2023,1142,3165
"Justice, 14th Court of Appeals District, Place 3",0645,1639,895,2534,4035,62.80%,1130,1268,2398
"Justice, 14th Court of Appeals District, Place 3",0646,708,456,1164,2163,53.81%,327,777,1104
"Justice, 14th Court of Appeals District, Place 3",0647,1771,1020,2791,5593,49.90%,672,1900,2572
"Justice, 14th Court of Appeals District, Place 3",0648,1590,668,2258,3197,70.63%,1530,627,2157
"Justice, 14th Court of Appeals District, Place 3",0649,1389,854,2243,4426,50.68%,589,1531,2120
"Justice, 14th Court of Appeals District, Place 3",0650,1328,939,2267,3151,71.95%,1616,543,2159
"Justice, 14th Court of Appeals District, Place 3",0651,2085,1070,3155,4931,63.98%,1906,1093,2999
"Justice, 14th Court of Appeals District, Place 3",0652,1050,653,1703,2633,64.68%,258,1380,1638
"Justice, 14th Court of Appeals District, Place 3",0653,0,8,8,0,0.00%,2,6,8
"Justice, 14th Court of Appeals District, Place 3",0654,2103,1344,3447,5765,59.79%,1683,1560,3243
"Justice, 14th Court of Appeals District, Place 3",0655,2613,1451,4064,6304,64.47%,2443,1405,3848
"Justice, 14th Court of Appeals District, Place 3",0656,1198,421,1619,2622,61.75%,44,1526,1570
"Justice, 14th Court of Appeals District, Place 3",0657,490,268,758,1200,63.17%,282,436,718
"Justice, 14th Court of Appeals District, Place 3",0658,985,708,1693,2824,59.95%,1007,620,1627
"Justice, 14th Court of Appeals District, Place 3",0659,2141,1091,3232,4588,70.44%,2231,862,3093
"Justice, 14th Court of Appeals District, Place 3",0660,2460,932,3392,5048,67.19%,304,2970,3274
"Justice, 14th Court of Appeals District, Place 3",0661,1614,1012,2626,4179,62.84%,1355,1132,2487
"Justice, 14th Court of Appeals District, Place 3",0662,2477,999,3476,4807,72.31%,2709,615,3324
"Justice, 14th Court of Appeals District, Place 3",0663,1302,913,2215,3232,68.53%,1171,879,2050
"Justice, 14th Court of Appeals District, Place 3",0664,681,607,1288,2801,45.98%,272,950,1222
"Justice, 14th Court of Appeals District, Place 3",0665,951,394,1345,2007,67.02%,1064,210,1274
"Justice, 14th Court of Appeals District, Place 3",0666,0,1,1,0,0.00%,0,1,1
"Justice, 14th Court of Appeals District, Place 3",0657,989,547,1536,2181,70.43%,1138,313,1451
"Justice, 14th Court of Appeals District, Place 3",0668,927,655,1582,2458,64.36%,952,550,1502
"Justice, 14th Court of Appeals District, Place 3",0669,1606,823,2429,3243,74.90%,1639,663,2302
"Justice, 14th Court of Appeals District, Place 3",0670,1566,518,2084,2952,70.60%,1568,390,1958
"Justice, 14th Court of Appeals District, Place 3",0671,1090,773,1863,2942,63.32%,1036,711,1747
"Justice, 14th Court of Appeals District, Place 3",0672,2301,1078,3379,4710,71.74%,2174,1077,3251
"Justice, 14th Court of Appeals District, Place 3",0673,1376,643,2019,2988,67.57%,1516,390,1906
"Justice, 14th Court of Appeals District, Place 3",0674,2092,813,2905,4055,71.64%,2116,682,2798
"Justice, 14th Court of Appeals District, Place 3",0675,0,0,0,0,0.00%,0,0,0
"Justice, 14th Court of Appeals District, Place 3",0676,0,0,0,0,0.00%,0,0,0
"Justice, 14th Court of Appeals District, Place 3",0677,220,239,459,954,48.11%,121,312,433
"Justice, 14th Court of Appeals District, Place 3",0678,297,164,461,756,60.98%,289,134,423
"Justice, 14th Court of Appeals District, Place 3",0679,1468,661,2129,3331,63.91%,1524,479,2003
"Justice, 14th Court of Appeals District, Place 3",0680,57,22,79,181,43.65%,31,41,72
"Justice, 14th Court of Appeals District, Place 3",0681,1,0,1,5,20.00%,0,1,1
"Justice, 14th Court of Appeals District, Place 3",0682,1674,912,2586,4134,62.55%,1794,668,2462
"Justice, 14th Court of Appeals District, Place 3",0683,48,50,98,261,37.55%,21,71,92
"Justice, 14th Court of Appeals District, Place 3",0684,72,24,96,187,51.34%,56,33,89
"Justice, 14th Court of Appeals District, Place 3",0685,167,29,196,326,60.12%,88,95,183
"Justice, 14th Court of Appeals District, Place 3",0686,46,34,80,196,40.82%,17,58,75
"Justice, 14th Court of Appeals District, Place 3",0687,1084,641,1725,2497,69.08%,1111,499,1610
"Justice, 14th Court of Appeals District, Place 3",0688,1815,673,2488,3266,76.18%,1943,426,2369
"Justice, 14th Court of Appeals District, Place 3",0689,505,651,1156,2276,50.79%,506,554,1060
"Justice, 14th Court of Appeals District, Place 3",0690,1966,1116,3082,4184,73.66%,2339,606,2945
"Justice, 14th Court of Appeals District, Place 3",0691,10,2,12,34,35.29%,4,8,12
"Justice, 14th Court of Appeals District, Place 3",0692,1000,717,1717,2626,65.38%,1221,413,1634
"Justice, 14th Court of Appeals District, Place 3",0693,303,116,419,651,64.36%,101,284,385
"Justice, 14th Court of Appeals District, Place 3",0694,420,137,557,817,68.18%,359,170,529
"Justice, 14th Court of Appeals District, Place 3",0695,454,320,774,1646,47.02%,457,280,737
"Justice, 14th Court of Appeals District, Place 3",0696,600,373,973,2098,46.38%,571,363,934
"Justice, 14th Court of Appeals District, Place 3",0697,1516,941,2457,4307,57.05%,535,1832,2367
"Justice, 14th Court of Appeals District, Place 3",0698,1137,659,1796,2948,60.92%,166,1565,1731
"Justice, 14th Court of Appeals District, Place 3",0699,1031,566,1597,2288,69.80%,977,489,1466
"Justice, 14th Court of Appeals District, Place 3",0700,531,287,818,1313,62.30%,635,141,776
"Justice, 14th Court of Appeals District, Place 3",0701,142,115,257,554,46.39%,120,124,244
"Justice, 14th Court of Appeals District, Place 3",0702,150,123,273,549,49.73%,26,234,260
"Justice, 14th Court of Appeals District, Place 3",0703,742,616,1358,1845,73.60%,932,329,1261
"Justice, 14th Court of Appeals District, Place 3",0704,1334,701,2035,2882,70.61%,1596,339,1935
"Justice, 14th Court of Appeals District, Place 3",0705,358,238,596,1520,39.21%,55,519,574
"Justice, 14th Court of Appeals District, Place 3",0706,222,135,357,529,67.49%,165,184,349
"Justice, 14th Court of Appeals District, Place 3",0707,284,1,36,420,707,59.41%,238,1,56,394
"Justice, 14th Court of Appeals District, Place 3",0708,109,95,204,568,35.92%,93,99,192
"Justice, 14th Court of Appeals District, Place 3",0709,2997,1297,4294,6239,68.83%,2461,1661,4122
"Justice, 14th Court of Appeals District, Place 3",0710,877,602,1479,2023,73.11%,835,530,1365
"Justice, 14th Court of Appeals District, Place 3",0711,1492,701,2193,3351,65.44%,1244,821,2065
"Justice, 14th Court of Appeals District, Place 3",0712,1200,858,2058,3348,61.47%,800,1193,1993
"Justice, 14th Court of Appeals District, Place 3",0713,665,436,1101,1827,60.26%,554,496,1050
"Justice, 14th Court of Appeals District, Place 3",0714,77,3,80,304,26.32%,50,25,75
"Justice, 14th Court of Appeals District, Place 3",0715,405,326,731,1380,52.97%,348,344,692
"Justice, 14th Court of Appeals District, Place 3",0716,977,622,1599,2670,59.89%,1090,440,1530
"Justice, 14th Court of Appeals District, Place 3",0717,826,362,1188,1927,61.65%,146,997,1143
"Justice, 14th Court of Appeals District, Place 3",0718,1844,1019,2863,4050,70.69%,1848,812,2660
"Justice, 14th Court of Appeals District, Place 3",0719,508,260,768,1617,47.50%,412,306,718
"Justice, 14th Court of Appeals District, Place 3",0720,1575,1044,2619,3903,67.10%,1836,679,2515
"Justice, 14th Court of Appeals District, Place 3",0721,1334,637,1971,2842,69.35%,1260,581,1841
"Justice, 14th Court of Appeals District, Place 3",0722,1892,642,2534,4357,58.16%,139,2298,2437
"Justice, 14th Court of Appeals District, Place 3",0723,747,329,1076,1760,61.14%,212,819,1031
"Justice, 14th Court of Appeals District, Place 3",0724,325,170,495,716,69.13%,326,144,470
"Justice, 14th Court of Appeals District, Place 3",0725,953,329,1282,2124,60.36%,510,703,1213
"Justice, 14th Court of Appeals District, Place 3",0726,1141,304,1445,1987,72.72%,1228,150,1378
"Justice, 14th Court of Appeals District, Place 3",0727,931,466,1397,2488,56.15%,327,1017,1344
"Justice, 14th Court of Appeals District, Place 3",0728,343,208,551,881,62.54%,293,222,515
"Justice, 14th Court of Appeals District, Place 3",0729,208,93,301,446,67.49%,171,116,287
"Justice, 14th Court of Appeals District, Place 3",0730,802,437,1239,1630,76.01%,800,347,1147
"Justice, 14th Court of Appeals District, Place 3",0731,122,36,158,373,42.36%,28,119,147
"Justice, 14th Court of Appeals District, Place 3",0732,701,543,1244,1895,65.65%,709,444,1153
"Justice, 14th Court of Appeals District, Place 3",0733,25,62,87,172,50.58%,26,53,79
"Justice, 14th Court of Appeals District, Place 3",0734,3209,1114,4323,5952,72.63%,2839,1329,4168
"Justice, 14th Court of Appeals District, Place 3",0735,9,0,9,23,39.1,3%,9,0,9
"Justice, 14th Court of Appeals District, Place 3",0736,6,1,7,21,33.33%,1,5,6
"Justice, 14th Court of Appeals District, Place 3",0737,25,5,30,53,56.60%,24,6,30
"Justice, 14th Court of Appeals District, Place 3",0738,470,219,689,1294,53.25%,71,600,671
"Justice, 14th Court of Appeals District, Place 3",0739,1005,490,1495,2872,52.05%,631,805,1436
"Justice, 14th Court of Appeals District, Place 3",0740,233,205,438,935,46.84%,227,194,421
"Justice, 14th Court of Appeals District, Place 3",0741,0,0,0,0,0.00%,0,0,0
"Justice, 14th Court of Appeals District, Place 3",0742,0,0,0,0,0.00%,0,0,0
"Justice, 14th Court of Appeals District, Place 3",0743,27,4,31,199,15.58%,12,17,29
"Justice, 14th Court of Appeals District, Place 3",0744,848,509,1357,2024,67.05%,844,435,1279
"Justice, 14th Court of Appeals District, Place 3",0745,1066,542,1608,2396,67.11%,978,528,1506
"Justice, 14th Court of Appeals District, Place 3",0746,230,151,381,707,53.89%,175,172,347
"Justice, 14th Court of Appeals District, Place 3",0747,1200,873,2073,3490,59.40%,934,1053,1987
"Justice, 14th Court of Appeals District, Place 3",0748,421,307,728,1319,55.19%,315,372,687
"Justice, 14th Court of Appeals District, Place 3",0749,99,57,156,359,43.45%,27,116,143
"Justice, 14th Court of Appeals District, Place 3",0750,264,147,411,720,57.08%,222,164,386
"Justice, 14th Court of Appeals District, Place 3",0751,1665,1254,2919,4451,65.58%,1891,895,2786
"Justice, 14th Court of Appeals District, Place 3",0752,571,277,848,1511,56.12%,578,224,802
"Justice, 14th Court of Appeals District, Place 3",0753,106,61,167,260,64.23%,106,57,163
"Justice, 14th Court of Appeals District, Place 3",0754,0,0,0,0,0.00%,0,0,0
"Justice, 14th Court of Appeals District, Place 3",0755,1048,896,1944,3569,54.47%,693,1151,1844
"Justice, 14th Court of Appeals District, Place 3",0756,582,300,882,1539,57.31%,289,546,835
"Justice, 14th Court of Appeals District, Place 3",0757,1416,690,2106,3498,60.21%,313,1727,2040
"Justice, 14th Court of Appeals District, Place 3",0758,1996,783,2779,3781,73.50%,2161,459,2620
"Justice, 14th Court of Appeals District, Place 3",0759,1109,590,1699,2625,64.72%,981,619,1600
"Justice, 14th Court of Appeals District, Place 3",0760,2346,647,2993,4154,72.05%,2413,430,2843
"Justice, 14th Court of Appeals District, Place 3",0761,917,219,1136,1464,77.60%,801,258,1059
"Justice, 14th Court of Appeals District, Place 3",0762,0,0,0,0,0.00%,0,0,0
"Justice, 14th Court of Appeals District, Place 3",0763,256,308,564,1184,47.64%,176,357,533
"Justice, 14th Court of Appeals District, Place 3",0764,2270,1050,3320,4931,67.33%,2035,1142,3177
"Justice, 14th Court of Appeals District, Place 3",0765,1390,815,2205,3967,55.58%,732,1381,2113
"Justice, 14th Court of Appeals District, Place 3",0766,71,92,163,383,42.56%,34,110,144
"Justice, 14th Court of Appeals District, Place 3",0767,20,15,35,90,38.89%,22,10,32
"Justice, 14th Court of Appeals District, Place 3",0768,2854,1159,4013,5364,74.81%,3090,759,3849
"Justice, 14th Court of Appeals District, Place 3",0769,117,5,122,161,75.78%,5,113,118
"Justice, 14th Court of Appeals District, Place 3",0770,58,48,106,262,40.46%,40,59,99
"Justice, 14th Court of Appeals District, Place 3",0771,702,537,1239,2378,52.10%,584,586,1170
"Justice, 14th Court of Appeals District, Place 3",0772,2929,1002,3931,5617,69.98%,2874,878,3752
"Justice, 14th Court of Appeals District, Place 3",0773,892,550,1442,2648,54.46%,338,1023,1361
"Justice, 14th Court of Appeals District, Place 3",0774,117,74,191,301,63.46%,41,144,185
"Justice, 14th Court of Appeals District, Place 3",0775,33,1,34,83,40.96%,1,32,33
"Justice, 14th Court of Appeals District, Place 3",0776,1113,741,1854,2855,64.94%,1042,733,1775
"Justice, 14th Court of Appeals District, Place 3",0777,83,123,206,642,32.09%,50,148,198
"Justice, 14th Court of Appeals District, Place 3",0778,0,0,0,0,0.00%,0,0,0
"Justice, 14th Court of Appeals District, Place 3",0779,295,221,516,1146,45.03%,154,326,480
"Justice, 14th Court of Appeals District, Place 3",0780,136,114,250,579,43.18%,106,128,234
"Justice, 14th Court of Appeals District, Place 3",0781,1152,655,1807,3716,48.63%,629,993,1622
"Justice, 14th Court of Appeals District, Place 3",0782,851,532,1383,2188,63.21%,807,495,1302
"Justice, 14th Court of Appeals District, Place 3",0783,103,43,146,265,55.09%,75,59,134
"Justice, 14th Court of Appeals District, Place 3",0784,428,156,584,1071,54.53%,6,559,565
"Justice, 14th Court of Appeals District, Place 3",0785,66,55,121,310,39.03%,63,56,119
"Justice, 14th Court of Appeals District, Place 3",0786,193,277,470,1297,36.24%,131,314,445
"Justice, 14th Court of Appeals District, Place 3",0787,154,76,230,487,47.23%,72,142,214
"Justice, 14th Court of Appeals District, Place 3",0788,156,58,214,481,44.49%,68,133,201
"Justice, 14th Court of Appeals District, Place 3",0789,3,1,4,4,100.00%,1,2,3
"Justice, 14th Court of Appeals District, Place 3",0790,1,0,1,4,25.00%,0,1,1
"Justice, 14th Court of Appeals District, Place 3",0791,0,0,0,0,0.00%,0,0,0
"Justice, 14th Court of Appeals District, Place 3",0792,549,409,958,1834,52.24%,204,701,905
"Justice, 14th Court of Appeals District, Place 3",0793,889,338,1227,2437,50.35%,670,501,1171
"Justice, 14th Court of Appeals District, Place 3",0794,575,484,1059,2602,40.70%,71,951,1022
"Justice, 14th Court of Appeals District, Place 3",0795,265,255,520,1207,43.08%,145,331,476
"Justice, 14th Court of Appeals District, Place 3",0796,145,92,237,485,48.87%,112,111,223
"Justice, 14th Court of Appeals District, Place 3",0797,0,0,0,0,0.00%,0,0,0
"Justice, 14th Court of Appeals District, Place 3",0798,176,263,439,496,88.51%,124,274,398
"Justice, 14th Court of Appeals District, Place 3",0799,65,12,77,146,52.74%,16,57,73
"Justice, 14th Court of Appeals District, Place 3",0800,1188,795,1983,2817,70.39%,1300,582,1882
"Justice, 14th Court of Appeals District, Place 3",0801,68,55,123,253,48.62%,38,78,116
"Justice, 14th Court of Appeals District, Place 3",0802,98,58,156,299,52.17%,27,117,144
"Justice, 14th Court of Appeals District, Place 3",0803,1305,530,1935,2718,71.19%,1394,450,1844
"Justice, 14th Court of Appeals District, Place 3",0804,1807,960,2767,4348,63.64%,1607,1020,2627
"Justice, 14th Court of Appeals District, Place 3",0805,1509,529,2038,2812,72.48%,1575,360,1935
"Justice, 14th Court of Appeals District, Place 3",0806,0,0,0,0,0.00%,0,0,0
"Justice, 14th Court of Appeals District, Place 3",0807,652,402,1054,2001,52.67%,157,851,1008
"Justice, 14th Court of Appeals District, Place 3",0808,41,26,67,84,79.76%,30,28,58
"Justice, 14th Court of Appeals District, Place 3",0809,216,27,86,31.40%,8,16,24
"Justice, 14th Court of Appeals District, Place 3",0810,30,48,78,215,36.28%,18,50,68
"Justice, 14th Court of Appeals District, Place 3",0811,39,106,145,271,53.51%,27,109,136
"Justice, 14th Court of Appeals District, Place 3",0812,0,0,0,0,0.00%,0,0,0
"Justice, 14th Court of Appeals District, Place 3",0813,1967,1258,3225,5423,59.47%,1496,1606,3102
"Justice, 14th Court of Appeals District, Place 3",0814,1773,955,2728,4503,60.58%,589,2031,2620
"Justice, 14th Court of Appeals District, Place 3",0815,0,0,0,0,0.00%,0,0,0
"Justice, 14th Court of Appeals District, Place 3",0816,20,13,33,76,43.42%,5,27,32
"Justice, 14th Court of Appeals District, Place 3",0817,0,0,0,0,0.00%,0,0,0
"Justice, 14th Court of Appeals District, Place 3",0818,134,101,235,527,44.59%,45,183,228
"Justice, 14th Court of Appeals District, Place 3",0819,97,45,142,238,59.66%,85,38,123
"Justice, 14th Court of Appeals District, Place 3",0820,0,0,0,0,0.00%,0,0,0
"Justice, 14th Court of Appeals District, Place 3",0821,354,203,557,1206,46.19%,50,485,535
"Justice, 14th Court of Appeals District, Place 3",0822,584,282,866,1544,56.09%,23,819,842
"Justice, 14th Court of Appeals District, Place 3",0823,1850,1015,2865,4710,60.83%,1426,1307,2733
"Justice, 14th Court of Appeals District, Place 3",0824,984,471,1455,2729,53.32%,302,1095,1397
"Justice, 14th Court of Appeals District, Place 3",0825,0,0,0,0,0.00%,0,0,0
"Justice, 14th Court of Appeals District, Place 3",0826,153,89,242,342,70.76%,126,101,227
"Justice, 14th Court of Appeals District, Place 3",0827,169,186,355,997,35.61%,125,212,337
"Justice, 14th Court of Appeals District, Place 3",0828,1074,343,1417,1875,75.57%,1100,235,1335
"Justice, 14th Court of Appeals District, Place 3",0829,107,56,163,266,61.28%,32,126,158
"Justice, 14th Court of Appeals District, Place 3",0830,0,0,0,1,0.00%,0,0,0
"Justice, 14th Court of Appeals District, Place 3",0831,0,0,0,0,0.00%,0,0,0
"Justice, 14th Court of Appeals District, Place 3",0832,109,46,155,351,44.16%,45,101,146
"Justice, 14th Court of Appeals District, Place 3",0833,8,1,9,20,45.00%,0,9,9
"Justice, 14th Court of Appeals District, Place 3",0834,0,0,0,0,0.00%,0,0,0
"Justice, 14th Court of Appeals District, Place 3",0835,87,53,140,292,47.95%,36,96,132
"Justice, 14th Court of Appeals District, Place 3",0836,8,3,11,19,57.89%,1,8,9
"Justice, 14th Court of Appeals District, Place 3",0837,0,0,0,0,0.00%,0,0,0
"Justice, 14th Court of Appeals District, Place 3",0838,0,0,0,0,0.00%,0,0,0
"Justice, 14th Court of Appeals District, Place 3",0839,353,240,593,1122,52.85%,104,452,556
"Justice, 14th Court of Appeals District, Place 3",0840,712,251,963,1621,59.41%,308,618,926
"Justice, 14th Court of Appeals District, Place 3",0841,0,2,2,0,0.00%,0,2,2
"Justice, 14th Court of Appeals District, Place 3",0842,988,715,1703,3091,55.10%,704,921,1625
"Justice, 14th Court of Appeals District, Place 3",0843,0,2,2,0,0.00%,0,2,2
"Justice, 14th Court of Appeals District, Place 3",0844,2,4,6,1,3,46.1,5%,1,4,5
"Justice, 14th Court of Appeals District, Place 3",0845,85,10,95,100,95.00%,54,34,88
"Justice, 14th Court of Appeals District, Place 3",0846,70,29,99,210,47.14%,6,91,97
"Justice, 14th Court of Appeals District, Place 3",0847,795,321,1116,1804,61.86%,292,779,1071
"Justice, 14th Court of Appeals District, Place 3",0848,782,431,1213,1873,64.76%,364,793,1157
"Justice, 14th Court of Appeals District, Place 3",0849,553,514,1067,2073,51.47%,320,681,1001
"Justice, 14th Court of Appeals District, Place 3",0850,87,38,125,205,60.98%,47,72,119
"Justice, 14th Court of Appeals District, Place 3",0851,2192,816,3008,4317,69.68%,1896,966,2862
"Justice, 14th Court of Appeals District, Place 3",0852,0,4,4,2,200.00%,0,4,4
"Justice, 14th Court of Appeals District, Place 3",0853,1413,605,2018,2773,72.77%,1502,413,1915
"Justice, 14th Court of Appeals District, Place 3",0854,41,30,71,175,40.57%,4,65,69
"Justice, 14th Court of Appeals District, Place 3",0855,4,13,17,18,94.44%,8,9,17
"Justice, 14th Court of Appeals District, Place 3",0856,0,4,4,0,0.00%,1,2,3
"Justice, 14th Court of Appeals District, Place 3",0857,0,0,0,1,0.00%,0,0,0
"Justice, 14th Court of Appeals District, Place 3",0858,132,18,150,372,40.32%,4,141,145
"Justice, 14th Court of Appeals District, Place 3",0859,309,201,510,860,59.30%,103,397,500
"Justice, 14th Court of Appeals District, Place 3",0860,0,1,1,0,0.00%,1,0,1
"Justice, 14th Court of Appeals District, Place 3",0861,705,319,1024,1786,57.33%,175,821,996
"Justice, 14th Court of Appeals District, Place 3",0862,0,0,0,0,0.00%,0,0,0
"Justice, 14th Court of Appeals District, Place 3",0863,210,69,279,620,45.00%,10,262,272
"Justice, 14th Court of Appeals District, Place 3",0864,497,609,1106,2464,44.89%,252,798,1050
"Justice, 14th Court of Appeals District, Place 3",0865,9,2,11,23,47.83%,0,11,11
"Justice, 14th Court of Appeals District, Place 3",0866,0,0,0,0,0.00%,0,0,0
"Justice, 14th Court of Appeals District, Place 3",0867,0,0,0,0,0.00%,0,0,0
"Justice, 14th Court of Appeals District, Place 3",0868,573,586,1159,2292,50.57%,335,765,1100
"Justice, 14th Court of Appeals District, Place 3",0869,153,76,229,473,48.41%,30,189,219
"Justice, 14th Court of Appeals District, Place 3",0870,0,0,0,0,0.00%,0,0,0
"Justice, 14th Court of Appeals District, Place 3",0871,3,0,3,4,75.00%,0,3,3
"Justice, 14th Court of Appeals District, Place 3",0872,13,5,18,66,27.27%,7,9,16
"Justice, 14th Court of Appeals District, Place 3",0873,253,125,378,701,53.92%,89,284,373
"Justice, 14th Court of Appeals District, Place 3",0874,1534,748,2282,3107,73.45%,1694,487,2181
"Justice, 14th Court of Appeals District, Place 3",0875,1719,927,2646,4031,65.64%,1211,1322,2533
"Justice, 14th Court of Appeals District, Place 3",0876,1629,639,2268,3013,75.27%,1608,574,2182
"Justice, 14th Court of Appeals District, Place 3",0877,1031,642,1673,2480,67.46%,674,952,1626
"Justice, 14th Court of Appeals District, Place 3",0878,853,350,1203,1641,73.31%,965,178,1143
"Justice, 14th Court of Appeals District, Place 3",0879,890,527,1417,2334,60.71%,631,730,1361
"Justice, 14th Court of Appeals District, Place 3",0880,1068,472,1540,2007,76.73%,1135,325,1460
"Justice, 14th Court of Appeals District, Place 3",0881,1510,877,2387,3619,65.96%,734,1572,2306
"Justice, 14th Court of Appeals District, Place 3",0882,940,457,1397,2328,60.01%,750,586,1336
"Justice, 14th Court of Appeals District, Place 3",0883,1918,1042,2960,4651,63.64%,495,2379,2874
"Justice, 14th Court of Appeals District, Place 3",0884,118,37,155,330,46.97%,19,129,148
"Justice, 14th Court of Appeals District, Place 3",0885,1222,541,1763,2466,71.49%,1018,662,1680
"Justice, 14th Court of Appeals District, Place 3",0886,301,154,455,713,63.81%,233,176,409
"Justice, 14th Court of Appeals District, Place 3",0887,138,83,221,313,70.61%,123,74,197
"Justice, 14th Court of Appeals District, Place 3",0888,0,0,0,0,0.00%,0,0,0
"Justice, 14th Court of Appeals District, Place 3",0889,22,0,22,61,36.07%,13,8,21
"Justice, 14th Court of Appeals District, Place 3",0890,321,118,439,994,44.16%,162,251,413
"Justice, 14th Court of Appeals District, Place 3",0891,539,392,931,1413,65.89%,354,514,868
"Justice, 14th Court of Appeals District, Place 3",0892,194,130,324,696,46.55%,89,210,299
"Justice, 14th Court of Appeals District, Place 3",0893,1,0,1,5,20.00%,0,1,1
"Justice, 14th Court of Appeals District, Place 3",0894,0,31,31,0,0.00%,8,20,28
"Justice, 14th Court of Appeals District, Place 3",0895,335,325,660,784,84.18%,288,312,600
"Justice, 14th Court of Appeals District, Place 3",0896,670,303,973,1437,67.71%,373,518,891
"Justice, 14th Court of Appeals District, Place 3",0897,742,375,1117,1624,68.78%,600,470,1070
"Justice, 14th Court of Appeals District, Place 3",0898,0,0,0,2,0.00%,0,0,0
"Justice, 14th Court of Appeals District, Place 3",0899,4,0,4,8,50.00%,0,4,4
"Justice, 14th Court of Appeals District, Place 3",0900,5,0,5,12,41.67%,1,3,4
"Justice, 14th Court of Appeals District, Place 3",0901,0,0,0,0,0.00%,0,0,0
"Justice, 14th Court of Appeals District, Place 3",0902,865,621,1486,2065,71.96%,819,547,1366
"Justice, 14th Court of Appeals District, Place 3",0903,10,1,11,41,26.83%,5,5,10
"Justice, 14th Court of Appeals District, Place 3",0904,0,1,1,1,100.00%,0,1,1
"Justice, 14th Court of Appeals District, Place 3",0905,290,168,458,908,50.44%,164,254,418
"Justice, 14th Court of Appeals District, Place 3",0906,12,6,18,26,69.23%,9,8,17
"Justice, 14th Court of Appeals District, Place 3",0907,60,43,103,134,76.87%,21,80,101
"Justice, 14th Court of Appeals District, Place 3",0908,0,0,0,0,0.00%,0,0,0
"Justice, 14th Court of Appeals District, Place 3",0909,5,7,12,19,63.16%,6,5,11
"Justice, 14th Court of Appeals District, Place 3",0910,55,34,89,226,39.38%,34,50,84
"Justice, 14th Court of Appeals District, Place 3",0911,227,79,306,570,53.68%,188,100,288
"Justice, 14th Court of Appeals District, Place 3",0912,675,221,896,1235,72.55%,529,306,835
"Justice, 14th Court of Appeals District, Place 3",0913,0,0,0,0,0.00%,0,0,0
"Justice, 14th Court of Appeals District, Place 3",0914,169,67,236,221,106.79%,181,40,221
"Justice, 14th Court of Appeals District, Place 3",0915,0,0,0,0,0.00%,0,0,0
"Justice, 14th Court of Appeals District, Place 3",0916,604,182,786,1045,75.22%,631,120,751
"Justice, 14th Court of Appeals District, Place 3",0917,280,137,417,481,86.69%,287,98,385
"Justice, 14th Court of Appeals District, Place 3",0918,489,135,624,883,70.67%,462,121,583
"Justice, 14th Court of Appeals District, Place 3",0919,0,3,3,3,100.00%,1,2,3
"Justice, 14th Court of Appeals District, Place 3",0920,6,0,6,13,46.15%,6,0,6
"Justice, 14th Court of Appeals District, Place 3",0921,71,9,80,87,91.95%,61,19,80
"Justice, 14th Court of Appeals District, Place 3",0922,0,2,2,0,0.00%,1,1,2
"Justice, 14th Court of Appeals District, Place 3",0923,664,87,751,826,90.92%,565,158,723
"Justice, 14th Court of Appeals District, Place 3",0924,0,0,0,0,0.00%,0,0,0
"Justice, 14th Court of Appeals District, Place 3",0925,0,0,0,0,0.00%,0,0,0
"Justice, 14th Court of Appeals District, Place 3",0926,351,1,20,481,621,77.46%,352,104,456
"Justice, 14th Court of Appeals District, Place 3",0927,84,74,158,262,60.31%,79,72,151
"Justice, 14th Court of Appeals District, Place 3",0928,4,2,6,9,66.67%,0,6,6
"Justice, 14th Court of Appeals District, Place 3",0929,0,0,0,0,0.00%,0,0,0
"Justice, 14th Court of Appeals District, Place 3",0930,200,77,277,567,48.85%,4,266,270
"Justice, 14th Court of Appeals District, Place 3",0931,48,53,101,122,82.79%,48,37,85
"Justice, 14th Court of Appeals District, Place 3",0932,0,5,5,0,0.00%,1,4,5
"Justice, 14th Court of Appeals District, Place 3",0933,235,121,356,566,62.90%,91,250,341
"Justice, 14th Court of Appeals District, Place 3",0934,12,1,13,41,31.71%,5,8,13
"Justice, 14th Court of Appeals District, Place 3",0935,8,17,25,65,38.46%,10,14,24
"Justice, 14th Court of Appeals District, Place 3",0936,12,10,22,70,31.43%,6,13,19
"Justice, 14th Court of Appeals District, Place 3",0937,0,0,0,0,0.00%,0,0,0
"Justice, 14th Court of Appeals District, Place 3",0938,73,14,87,256,33.98%,26,57,83
"Justice, 14th Court of Appeals District, Place 3",0939,1,0,1,1,100.00%,0,1,1
"Justice, 14th Court of Appeals District, Place 3",0940,1,0,1,13,7.69%,0,1,1
"Justice, 14th Court of Appeals District, Place 3",0941,13,9,22,25,88.00%,19,3,22
"Justice, 14th Court of Appeals District, Place 3",0942,68,24,92,159,57.86%,74,12,86
"Justice, 14th Court of Appeals District, Place 3",0943,297,63,360,536,67.16%,250,79,329
"Justice, 14th Court of Appeals District, Place 3",0944,30,6,36,39,92.31%,29,4,33
"Justice, 14th Court of Appeals District, Place 3",0945,4,7,11,16,68.75%,1,8,9
"Justice, 14th Court of Appeals District, Place 3",0946,3,3,6,14,42.86%,0,4,4
"Justice, 14th Court of Appeals District, Place 3",0947,320,292,612,822,74.45%,303,241,544
"Justice, 14th Court of Appeals District, Place 3",0948,0,0,0,0,0.00%,0,0,0
"Justice, 14th Court of Appeals District, Place 3",0949,59,37,96,201,47.76%,40,50,90
"Justice, 14th Court of Appeals District, Place 3",0950,0,0,0,0,0.00%,0,0,0
"Justice, 14th Court of Appeals District, Place 3",0951,79,44,123,218,56.42%,24,93,117
"Justice, 14th Court of Appeals District, Place 3",0952,24,16,40,70,57.14%,20,16,36
"Justice, 14th Court of Appeals District, Place 3",0953,59,52,111,420,26.43%,6,104,110
"Justice, 14th Court of Appeals District, Place 3",0954,0,0,0,0,0.00%,0,0,0
"Justice, 14th Court of Appeals District, Place 3",0955,5,20,25,18,138.89%,14,10,24
"Justice, 14th Court of Appeals District, Place 3",0956,5,2,7,12,58.33%,4,3,7
"Justice, 14th Court of Appeals District, Place 3",0957,261,115,376,551,68.24%,57,305,362
"Justice, 14th Court of Appeals District, Place 3",0958,289,266,555,989,56.12%,114,411,525
"Justice, 14th Court of Appeals District, Place 3",0959,0,4,4,0,0.00%,0,4,4
"Justice, 14th Court of Appeals District, Place 3",0960,363,143,506,586,86.35%,130,360,490
"Justice, 14th Court of Appeals District, Place 3",0961,23,11,34,53,64.15%,7,27,34
"Justice, 14th Court of Appeals District, Place 3",0962,24,13,37,73,50.68%,8,25,33
"Justice, 14th Court of Appeals District, Place 3",0963,130,69,199,353,56.37%,105,79,184
"Justice, 14th Court of Appeals District, Place 3",0964,947,447,1394,1571,88.73%,826,518,1344
"Justice, 14th Court of Appeals District, Place 3",0965,93,27,120,355,33.80%,74,39,113
"Justice, 14th Court of Appeals District, Place 3",0966,305,160,465,1073,43.34%,131,309,440
"Justice, 14th Court of Appeals District, Place 3",0967,48,15,63,98,64.29%,27,35,62
"Justice, 14th Court of Appeals District, Place 3",0968,243,83,326,517,63.06%,61,256,317
"Justice, 14th Court of Appeals District, Place 3",0969,335,82,417,584,71.40%,2,402,404
"Justice, 14th Court of Appeals District, Place 3",0970,212,76,288,704,40.91%,25,243,268
"Justice, 14th Court of Appeals District, Place 3",0971,27,21,48,129,37.21%,1,46,47
"Justice, 14th Court of Appeals District, Place 3",0972,10,7,17,29,58.62%,11,5,16
"Justice, 14th Court of Appeals District, Place 3",0973,49,24,73,107,68.22%,39,31,70
"Justice, 14th Court of Appeals District, Place 3",0974,101,71,172,299,57.53%,108,56,164
"Justice, 14th Court of Appeals District, Place 3",0975,72,41,113,170,66.47%,50,53,103
"Justice, 14th Court of Appeals District, Place 3",0976,159,131,290,684,42.40%,161,110,271
"Justice, 14th Court of Appeals District, Place 3",0977,104,83,187,535,34.95%,65,112,177
"Justice, 14th Court of Appeals District, Place 3",0978,201,102,303,506,59.88%,49,244,293
"Justice, 14th Court of Appeals District, Place 3",0979,56,11,26,42.31%,11,0,11
"Justice, 14th Court of Appeals District, Place 3",0980,595,356,951,1323,71.88%,666,228,894
"Justice, 14th Court of Appeals District, Place 3",0981,0,0,0,0,0.00%,0,0,0
"Justice, 14th Court of Appeals District, Place 3",0982,534,218,752,1021,73.65%,578,137,715
"Justice, 14th Court of Appeals District, Place 3",0983,41,28,69,165,41.82%,39,26,65
"Justice, 14th Court of Appeals District, Place 3",0984,43,49,92,198,46.46%,6,83,89
"Justice, 14th Court of Appeals District, Place 3",0985,172,67,239,336,71.13%,115,110,225
"Justice, 14th Court of Appeals District, Place 3",0986,129,86,215,404,53.22%,19,181,200
"Justice, 14th Court of Appeals District, Place 3",0987,465,191,656,1138,57.64%,52,586,638
"Justice, 14th Court of Appeals District, Place 3",0988,44,21,65,111,58.56%,51,11,62
"Justice, 14th Court of Appeals District, Place 3",0989,18,8,26,36,72.22%,12,13,25
"Justice, 14th Court of Appeals District, Place 3",0990,37,15,52,154,33.77%,13,32,45
"Justice, 14th Court of Appeals District, Place 3",0991,0,0,0,1,0.00%,0,0,0
"Justice, 14th Court of Appeals District, Place 3",0992,310,202,512,1015,50.44%,279,213,492
"Justice, 14th Court of Appeals District, Place 3",0993,272,91,363,551,65.88%,281,57,338
"Justice, 14th Court of Appeals District, Place 3",0994,6,5,11,8,137.50%,2,8,10
"Justice, 14th Court of Appeals District, Place 3",0995,596,190,786,1269,61.94%,32,724,756
"Justice, 14th Court of Appeals District, Place 3",0996,297,125,422,699,60.37%,226,168,394
"Justice, 14th Court of Appeals District, Place 3",0997,429,328,757,1439,52.61%,116,620,736
"Justice, 14th Court of Appeals District, Place 3",0998,15,9,24,35,68.57%,16,7,23
"Justice, 14th Court of Appeals District, Place 3",0999,30,16,46,65,70.77%,35,8,43
"Justice, 14th Court of Appeals District, Place 3",1000,105,0,105,458,22.93%,18,80,98
"Justice, 14th Court of Appeals District, Place 3",1001,496,294,790,1566,50.45%,141,608,749
"Justice, 14th Court of Appeals District, Place 3",1002,464,314,778,1738,44.76%,83,665,748
"Justice, 14th Court of Appeals District, Place 3",1003,0,0,0,1,0.00%,0,0,0
"Justice, 14th Court of Appeals District, Place 3",1,004,224,1,53,377,656,57.47%,184,149,333
"Justice, 14th Court of Appeals District, Place 3",1005,0,0,0,0,0.00%,0,0,0
"Justice, 14th Court of Appeals District, Place 3",1006,3,0,3,5,60.00%,3,0,3
"Justice, 14th Court of Appeals District, Place 3",1007,555,295,850,1371,62.00%,199,622,821
"Justice, 14th Court of Appeals District, Place 3",1008,86,21,107,150,71.33%,77,24,101
"Justice, 14th Court of Appeals District, Place 3",1009,3,1,4,8,50.00%,4,0,4
"Justice, 14th Court of Appeals District, Place 3",1010,125,74,199,317,62.78%,28,163,191
"Justice, 14th Court of Appeals District, Place 3",1011,12,3,15,29,51.72%,4,9,13
"Justice, 14th Court of Appeals District, Place 3",1012,395,318,713,1235,57.73%,189,498,687
"Justice, 14th Court of Appeals District, Place 3",1013,8,14,22,60,36.67%,15,7,22
"Justice, 14th Court of Appeals District, Place 3",1014,9,7,16,36,44.44%,3,13,16
"Justice, 14th Court of Appeals District, Place 3",1015,11,7,18,29,62.07%,4,13,17
"Justice, 14th Court of Appeals District, Place 3",1016,591,364,955,1626,58.73%,413,494,907
"Justice, 14th Court of Appeals District, Place 3",1017,127,50,177,232,76.29%,45,124,169
"Justice, 14th Court of Appeals District, Place 3",1018,209,92,301,468,64.32%,136,154,290
"Justice, 14th Court of Appeals District, Place 3",1019,426,4,430,1518,28.33%,16,396,412
"Justice, 14th Court of Appeals District, Place 3",1020,0,0,0,1,0.00%,0,0,0
"Justice, 14th Court of Appeals District, Place 3",1021,1,0,1,2,50.00%,0,1,1
"Justice, 14th Court of Appeals District, Place 3",1022,190,30,220,426,51.64%,170,40,210
"Justice, 14th Court of Appeals District, Place 3",1023,894,401,1295,1964,65.94%,824,407,1231
"Justice, 14th Court of Appeals District, Place 3",1024,113,77,190,259,73.36%,100,74,174
"Justice, 14th Court of Appeals District, Place 3",1025,4,0,4,18,22.22%,1,3,4
"Justice, 14th Court of Appeals District, Place 3",1026,0,0,0,0,0.00%,0,0,0
"Justice, 14th Court of Appeals District, Place 3",1027,0,1,1,1,100.00%,0,0,0
"Justice, 14th Court of Appeals District, Place 3",1028,0,1,1,0,0.00%,1,0,1
"Justice, 14th Court of Appeals District, Place 3",1029,1021,641,1662,1802,92.23%,1263,308,1571
"Justice, 14th Court of Appeals District, Place 3",1030,397,105,502,655,76.64%,426,59,485
"Justice, 14th Court of Appeals District, Place 3",1031,3,3,6,6,100.00%,5,1,6
"Justice, 14th Court of Appeals District, Place 3",1032,59,80,139,241,57.68%,98,32,130
"Justice, 14th Court of Appeals District, Place 3",1033,0,0,0,0,0.00%,0,0,0
"Justice, 14th Court of Appeals District, Place 3",1034,0,0,0,1,0.00%,0,0,0
"Justice, 14th Court of Appeals District, Place 3",1035,24,13,37,139,26.62%,3,33,36
"Justice, 14th Court of Appeals District, Place 3",1036,144,46,190,433,43.88%,144,36,180
"Justice, 14th Court of Appeals District, Place 3",1037,27,16,43,73,58.90%,21,16,37
"Justice, 14th Court of Appeals District, Place 3",1038,133,43,176,266,66.17%,10,162,172
"Justice, 14th Court of Appeals District, Place 3",1039,3,5,8,20,40.00%,1,7,8
"Justice, 14th Court of Appeals District, Place 3",1040,194,146,340,607,56.01%,174,147,321
"Justice, 14th Court of Appeals District, Place 3",1041,0,0,0,0,0.00%,0,0,0
"Justice, 14th Court of Appeals District, Place 3",1042,227,50,277,498,55.62%,78,193,271
"Justice, 14th Court of Appeals District, Place 3",1043,12,2,14,31,45.16%,3,11,14
"Justice, 14th Court of Appeals District, Place 3",1044,29,5,34,59,57.63%,7,26,33
"Justice, 14th Court of Appeals District, Place 3",1045,612,321,933,1439,64.84%,118,791,909
"Justice, 14th Court of Appeals District, Place 3",1046,19,18,37,54,68.52%,4,32,36
"Justice, 14th Court of Appeals District, Place 3",1047,553,288,851,1242,68.52%,252,563,815
"Justice, 14th Court of Appeals District, Place 3",1048,3,1,4,18,22.22%,2,2,4
"Justice, 14th Court of Appeals District, Place 3",1049,57,71,128,266,48.12%,38,83,121
"Justice, 14th Court of Appeals District, Place 3",1050,148,153,301,506,59.49%,59,227,286
"Justice, 14th Court of Appeals District, Place 3",1,051,0,1,2,1,2,0,0.00%,9,3,1,2
"Justice, 14th Court of Appeals District, Place 3",1052,0,2,2,0,0.00%,1,0,1
"Justice, 14th Court of Appeals District, Place 3",1053,0,0,0,0,0.00%,0,0,0
"Justice, 14th Court of Appeals District, Place 3",1054,0,0,0,1,0.00%,0,0,0
"Justice, 14th Court of Appeals District, Place 3",1055,0,0,0,0,0.00%,0,0,0
"Justice, 14th Court of Appeals District, Place 3",1056,4,0,4,6,66.67%,0,4,4
"Justice, 14th Court of Appeals District, Place 3",1057,34,7,41,115,35.65%,2,35,37
"Justice, 14th Court of Appeals District, Place 3",1058,540,246,786,1190,66.05%,117,644,761
"Justice, 14th Court of Appeals District, Place 3",1059,7,3,10,23,43.48%,1,9,10
"Justice, 14th Court of Appeals District, Place 3",1060,13,4,17,49,34.69%,9,8,17
"Justice, 14th Court of Appeals District, Place 3",1061,665,300,965,1613,59.83%,503,422,925
"Justice, 14th Court of Appeals District, Place 3",1062,59,25,85,168,50.60%,20,61,81
"Justice, 14th Court of Appeals District, Place 3",1063,226,63,289,792,36.49%,31,249,280
"Justice, 14th Court of Appeals District, Place 3",1064,45,1,46,120,38.33%,33,11,44
"Justice, 14th Court of Appeals District, Place 3",Totals:,774863,427100,1201963,1942566,,557224,580356,1137580
